date,geography,geography code,Rural Urban,Household Spaces: All categories: Household spaces; measures: Value,Household Spaces: Household spaces with at least one usual resident; measures: Value,Household Spaces: Household spaces with no usual residents; measures: Value
2011,AL1  1,AL1  1,Total,2546,2454,92
2011,AL1  2,AL1  2,Total,2642,2577,65
2011,AL1  3,AL1  3,Total,2272,2110,162
2011,AL1  4,AL1  4,Total,3707,3611,96
2011,AL1  5,AL1  5,Total,4406,4247,159
2011,AL10 0,AL10 0,Total,4404,4201,203
2011,AL10 8,AL10 8,Total,4181,4071,110
2011,AL10 9,AL10 9,Total,4662,4390,272
2011,AL2  1,AL2  1,Total,3906,3763,143
2011,AL2  2,AL2  2,Total,2597,2513,84
2011,AL2  3,AL2  3,Total,3320,3180,140
2011,AL3  4,AL3  4,Total,2416,2320,96
2011,AL3  5,AL3  5,Total,3555,3424,131
2011,AL3  6,AL3  6,Total,1645,1602,43
2011,AL3  7,AL3  7,Total,2274,2199,75
2011,AL3  8,AL3  8,Total,1919,1874,45
2011,AL4  0,AL4  0,Total,3566,3459,107
2011,AL4  8,AL4  8,Total,2670,2617,53
2011,AL4  9,AL4  9,Total,4820,4711,109
2011,AL5  1,AL5  1,Total,2459,2411,48
2011,AL5  2,AL5  2,Total,1913,1835,78
2011,AL5  3,AL5  3,Total,1678,1630,48
2011,AL5  4,AL5  4,Total,2588,2517,71
2011,AL5  5,AL5  5,Total,3255,3191,64
2011,AL6  0,AL6  0,Total,2596,2536,60
2011,AL6  9,AL6  9,Total,2112,1987,125
2011,AL7  1,AL7  1,Total,2523,2484,39
2011,AL7  2,AL7  2,Total,3404,3333,71
2011,AL7  3,AL7  3,Total,4186,4009,177
2011,AL7  4,AL7  4,Total,4624,4318,306
2011,AL8  6,AL8  6,Total,2760,2669,91
2011,AL8  7,AL8  7,Total,3014,2941,73
2011,AL9  5,AL9  5,Total,970,886,84
2011,AL9  6,AL9  6,Total,583,531,52
2011,AL9  7,AL9  7,Total,2902,2780,122
2011,B1   1,B1   1,Total,2439,2168,271
2011,B1   2,B1   2,Total,1623,1454,169
2011,B1   3,B1   3,Total,643,618,25
2011,B10  0,B10  0,Total,2608,2524,84
2011,B10  9,B10  9,Total,4674,4527,147
2011,B11  1,B11  1,Total,3329,3284,45
2011,B11  2,B11  2,Total,1156,1120,36
2011,B11  3,B11  3,Total,5650,5385,265
2011,B11  4,B11  4,Total,3086,2964,122
2011,B12  0,B12  0,Total,1909,1878,31
2011,B12  8,B12  8,Total,2572,2479,93
2011,B12  9,B12  9,Total,2433,2362,71
2011,B13  0,B13  0,Total,5438,5280,158
2011,B13  8,B13  8,Total,3664,3458,206
2011,B13  9,B13  9,Total,6644,6342,302
2011,B14  4,B14  4,Total,5333,5213,120
2011,B14  5,B14  5,Total,4984,4790,194
2011,B14  6,B14  6,Total,5117,4981,136
2011,B14  7,B14  7,Total,3377,3216,161
2011,B15  1,B15  1,Total,1201,1160,41
2011,B15  2,B15  2,Total,3376,3273,103
2011,B15  3,B15  3,Total,2063,1936,127
2011,B16  0,B16  0,Total,3672,3494,178
2011,B16  8,B16  8,Total,3762,3567,195
2011,B16  9,B16  9,Total,3445,3297,148
2011,B17  0,B17  0,Total,4271,4088,183
2011,B17  8,B17  8,Total,3558,3418,140
2011,B17  9,B17  9,Total,3601,3443,158
2011,B18  4,B18  4,Total,2146,2075,71
2011,B18  5,B18  5,Total,2108,2018,90
2011,B18  6,B18  6,Total,1107,1042,65
2011,B18  7,B18  7,Total,1117,1097,20
2011,B19  1,B19  1,Total,2687,2556,131
2011,B19  2,B19  2,Total,2656,2618,38
2011,B19  3,B19  3,Total,1347,1314,33
2011,B2   4,B2   4,Total,357,335,22
2011,B2   5,B2   5,Total,146,110,36
2011,B20  1,B20  1,Total,2830,2746,84
2011,B20  2,B20  2,Total,3881,3747,134
2011,B20  3,B20  3,Total,4731,4557,174
2011,B21  0,B21  0,Total,3538,3378,160
2011,B21  8,B21  8,Total,3354,3203,151
2011,B21  9,B21  9,Total,3445,3273,172
2011,B23  5,B23  5,Total,6940,6748,192
2011,B23  6,B23  6,Total,5296,5055,241
2011,B23  7,B23  7,Total,7030,6845,185
2011,B24  0,B24  0,Total,4682,4531,151
2011,B24  8,B24  8,Total,3113,3000,113
2011,B24  9,B24  9,Total,4591,4403,188
2011,B25  8,B25  8,Total,6148,6006,142
2011,B26  1,B26  1,Total,4602,4496,106
2011,B26  2,B26  2,Total,4728,4582,146
2011,B26  3,B26  3,Total,4605,4481,124
2011,B27  6,B27  6,Total,4032,3901,131
2011,B27  7,B27  7,Total,6173,6012,161
2011,B28  0,B28  0,Total,5605,5448,157
2011,B28  8,B28  8,Total,2712,2641,71
2011,B28  9,B28  9,Total,2963,2828,135
2011,B29  4,B29  4,Total,2778,2721,57
2011,B29  5,B29  5,Total,4282,4182,100
2011,B29  6,B29  6,Total,4496,4297,199
2011,B29  7,B29  7,Total,4021,3842,179
2011,B3   1,B3   1,Total,1686,1516,170
2011,B3   2,B3   2,Total,98,89,9
2011,B30  1,B30  1,Total,4569,4463,106
2011,B30  2,B30  2,Total,5087,4840,247
2011,B30  3,B30  3,Total,3367,3242,125
2011,B31  1,B31  1,Total,4992,4765,227
2011,B31  2,B31  2,Total,5370,5213,157
2011,B31  3,B31  3,Total,4967,4857,110
2011,B31  4,B31  4,Total,4532,4363,169
2011,B31  5,B31  5,Total,3853,3779,74
2011,B32  1,B32  1,Total,3989,3846,143
2011,B32  2,B32  2,Total,5233,5065,168
2011,B32  3,B32  3,Total,5214,5123,91
2011,B32  4,B32  4,Total,2315,2279,36
2011,B33  0,B33  0,Total,4729,4585,144
2011,B33  8,B33  8,Total,4655,4556,99
2011,B33  9,B33  9,Total,4744,4600,144
2011,B34  6,B34  6,Total,4717,4598,119
2011,B34  7,B34  7,Total,3655,3588,67
2011,B35  6,B35  6,Total,1973,1943,30
2011,B35  7,B35  7,Total,2326,2304,22
2011,B36  0,B36  0,Total,5396,5262,134
2011,B36  8,B36  8,Total,4589,4467,122
2011,B36  9,B36  9,Total,4054,3982,72
2011,B37  5,B37  5,Total,4461,4400,61
2011,B37  6,B37  6,Total,5139,5035,104
2011,B37  7,B37  7,Total,5949,5865,84
2011,B38  0,B38  0,Total,811,787,24
2011,B38  8,B38  8,Total,4015,3914,101
2011,B38  9,B38  9,Total,4383,4300,83
2011,B4   6,B4   6,Total,200,192,8
2011,B4   7,B4   7,Total,452,428,24
2011,B42  1,B42  1,Total,4335,4175,160
2011,B42  2,B42  2,Total,5301,5148,153
2011,B43  5,B43  5,Total,4686,4502,184
2011,B43  6,B43  6,Total,2827,2659,168
2011,B43  7,B43  7,Total,4604,4478,126
2011,B44  0,B44  0,Total,6109,5949,160
2011,B44  8,B44  8,Total,4258,4148,110
2011,B44  9,B44  9,Total,5003,4880,123
2011,B45  0,B45  0,Total,3182,3140,42
2011,B45  8,B45  8,Total,4517,4401,116
2011,B45  9,B45  9,Total,5376,5232,144
2011,B46  1,B46  1,Total,3208,3073,135
2011,B46  2,B46  2,Total,921,877,44
2011,B46  3,B46  3,Total,1277,1202,75
2011,B47  5,B47  5,Total,2887,2842,45
2011,B47  6,B47  6,Total,1216,1174,42
2011,B48  7,B48  7,Total,2469,2391,78
2011,B49  5,B49  5,Total,2108,2003,105
2011,B49  6,B49  6,Total,2558,2485,73
2011,B5   4,B5   4,Total,1571,1332,239
2011,B5   5,B5   5,Total,178,167,11
2011,B5   6,B5   6,Total,190,135,55
2011,B5   7,B5   7,Total,3480,3392,88
2011,B50  4,B50  4,Total,2232,2171,61
2011,B6   4,B6   4,Total,376,370,6
2011,B6   5,B6   5,Total,1518,1497,21
2011,B6   6,B6   6,Total,3079,3025,54
2011,B6   7,B6   7,Total,1126,1042,84
2011,B60  1,B60  1,Total,3366,3245,121
2011,B60  2,B60  2,Total,3273,3203,70
2011,B60  3,B60  3,Total,3857,3787,70
2011,B60  4,B60  4,Total,1506,1445,61
2011,B61  0,B61  0,Total,4224,4120,104
2011,B61  7,B61  7,Total,2056,1999,57
2011,B61  8,B61  8,Total,2627,2562,65
2011,B61  9,B61  9,Total,1063,1020,43
2011,B62  0,B62  0,Total,2689,2628,61
2011,B62  8,B62  8,Total,3451,3333,118
2011,B62  9,B62  9,Total,4377,4245,132
2011,B63  1,B63  1,Total,2487,2447,40
2011,B63  2,B63  2,Total,5230,5042,188
2011,B63  3,B63  3,Total,3555,3433,122
2011,B63  4,B63  4,Total,4741,4605,136
2011,B64  5,B64  5,Total,1762,1661,101
2011,B64  6,B64  6,Total,3174,3001,173
2011,B64  7,B64  7,Total,2416,2302,114
2011,B65  0,B65  0,Total,2699,2574,125
2011,B65  8,B65  8,Total,3169,3038,131
2011,B65  9,B65  9,Total,4365,4183,182
2011,B66  1,B66  1,Total,1128,1070,58
2011,B66  2,B66  2,Total,538,514,24
2011,B66  3,B66  3,Total,2676,2606,70
2011,B66  4,B66  4,Total,3309,3146,163
2011,B67  5,B67  5,Total,4436,4214,222
2011,B67  6,B67  6,Total,4125,3991,134
2011,B67  7,B67  7,Total,3579,3437,142
2011,B68  0,B68  0,Total,4107,3897,210
2011,B68  8,B68  8,Total,4133,3951,182
2011,B68  9,B68  9,Total,4624,4419,205
2011,B69  1,B69  1,Total,6143,5923,220
2011,B69  2,B69  2,Total,2179,2034,145
2011,B69  3,B69  3,Total,1431,1364,67
2011,B69  4,B69  4,Total,2228,2146,82
2011,B7   4,B7   4,Total,1514,1485,29
2011,B7   5,B7   5,Total,2014,1958,56
2011,B70  0,B70  0,Total,2747,2638,109
2011,B70  6,B70  6,Total,2853,2735,118
2011,B70  7,B70  7,Total,1292,1253,39
2011,B70  8,B70  8,Total,1314,1257,57
2011,B70  9,B70  9,Total,3014,2812,202
2011,B71  1,B71  1,Total,3344,3228,116
2011,B71  2,B71  2,Total,4144,4000,144
2011,B71  3,B71  3,Total,3895,3695,200
2011,B71  4,B71  4,Total,1639,1589,50
2011,B72  1,B72  1,Total,4043,3902,141
2011,B73  5,B73  5,Total,5863,5657,206
2011,B73  6,B73  6,Total,4075,3947,128
2011,B74  2,B74  2,Total,4204,4074,130
2011,B74  3,B74  3,Total,4777,4597,180
2011,B74  4,B74  4,Total,5006,4797,209
2011,B75  5,B75  5,Total,3400,3309,91
2011,B75  6,B75  6,Total,3742,3635,107
2011,B75  7,B75  7,Total,4173,4037,136
2011,B76  0,B76  0,Total,170,153,17
2011,B76  1,B76  1,Total,5037,4920,117
2011,B76  2,B76  2,Total,2860,2801,59
2011,B76  9,B76  9,Total,1376,1310,66
2011,B77  1,B77  1,Total,4430,4334,96
2011,B77  2,B77  2,Total,5842,5724,118
2011,B77  3,B77  3,Total,3738,3669,69
2011,B77  4,B77  4,Total,5695,5613,82
2011,B77  5,B77  5,Total,3606,3533,73
2011,B78  1,B78  1,Total,4236,4092,144
2011,B78  2,B78  2,Total,1894,1815,79
2011,B78  3,B78  3,Total,4315,4075,240
2011,B79  0,B79  0,Total,1298,1247,51
2011,B79  7,B79  7,Total,3141,3029,112
2011,B79  8,B79  8,Total,4556,4477,79
2011,B79  9,B79  9,Total,948,887,61
2011,B8   1,B8   1,Total,2893,2770,123
2011,B8   2,B8   2,Total,4963,4768,195
2011,B8   3,B8   3,Total,4522,4347,175
2011,B80  7,B80  7,Total,3106,2983,123
2011,B9   4,B9   4,Total,1588,1556,32
2011,B9   5,B9   5,Total,6113,5951,162
2011,B90  1,B90  1,Total,4811,4637,174
2011,B90  2,B90  2,Total,5379,5272,107
2011,B90  3,B90  3,Total,4357,4247,110
2011,B90  4,B90  4,Total,4766,4677,89
2011,B91  1,B91  1,Total,4402,4237,165
2011,B91  2,B91  2,Total,5208,5015,193
2011,B91  3,B91  3,Total,4334,4213,121
2011,B92  0,B92  0,Total,1732,1683,49
2011,B92  7,B92  7,Total,5449,5274,175
2011,B92  8,B92  8,Total,5406,5273,133
2011,B92  9,B92  9,Total,3545,3478,67
2011,B93  0,B93  0,Total,1636,1588,48
2011,B93  8,B93  8,Total,3143,3068,75
2011,B93  9,B93  9,Total,3433,3364,69
2011,B94  5,B94  5,Total,1660,1553,107
2011,B94  6,B94  6,Total,1476,1440,36
2011,B95  5,B95  5,Total,1914,1812,102
2011,B95  6,B95  6,Total,886,824,62
2011,B96  6,B96  6,Total,2325,2215,110
2011,B97  4,B97  4,Total,2547,2453,94
2011,B97  5,B97  5,Total,7155,7009,146
2011,B97  6,B97  6,Total,4234,4162,72
2011,B98  0,B98  0,Total,6039,5959,80
2011,B98  7,B98  7,Total,7995,7828,167
2011,B98  8,B98  8,Total,3965,3872,93
2011,B98  9,B98  9,Total,2717,2668,49
2011,BA1  1,BA1  1,Total,1072,931,141
2011,BA1  2,BA1  2,Total,3896,3586,310
2011,BA1  3,BA1  3,Total,3235,3121,114
2011,BA1  4,BA1  4,Total,2394,2307,87
2011,BA1  5,BA1  5,Total,2274,2146,128
2011,BA1  6,BA1  6,Total,4027,3864,163
2011,BA1  7,BA1  7,Total,2422,2340,82
2011,BA1  8,BA1  8,Total,384,373,11
2011,BA1  9,BA1  9,Total,105,98,7
2011,BA10 0,BA10 0,Total,1474,1379,95
2011,BA11 1,BA11 1,Total,2450,2219,231
2011,BA11 2,BA11 2,Total,4826,4664,162
2011,BA11 3,BA11 3,Total,2199,2071,128
2011,BA11 4,BA11 4,Total,2817,2693,124
2011,BA11 5,BA11 5,Total,1500,1374,126
2011,BA11 6,BA11 6,Total,844,803,41
2011,BA12 0,BA12 0,Total,2542,2327,215
2011,BA12 6,BA12 6,Total,2057,1940,117
2011,BA12 7,BA12 7,Total,1428,1337,91
2011,BA12 8,BA12 8,Total,4140,3905,235
2011,BA12 9,BA12 9,Total,3068,2930,138
2011,BA13 2,BA13 2,Total,458,452,6
2011,BA13 3,BA13 3,Total,5641,5490,151
2011,BA13 4,BA13 4,Total,2619,2522,97
2011,BA14 0,BA14 0,Total,5356,5275,81
2011,BA14 6,BA14 6,Total,2599,2524,75
2011,BA14 7,BA14 7,Total,6296,6121,175
2011,BA14 8,BA14 8,Total,2819,2673,146
2011,BA14 9,BA14 9,Total,3536,3466,70
2011,BA15 1,BA15 1,Total,4354,4197,157
2011,BA15 2,BA15 2,Total,1726,1670,56
2011,BA16 0,BA16 0,Total,4333,4157,176
2011,BA16 9,BA16 9,Total,1136,1110,26
2011,BA2  0,BA2  0,Total,2016,1953,63
2011,BA2  1,BA2  1,Total,5451,5346,105
2011,BA2  2,BA2  2,Total,4425,4365,60
2011,BA2  3,BA2  3,Total,3358,3284,74
2011,BA2  4,BA2  4,Total,2905,2710,195
2011,BA2  5,BA2  5,Total,3199,3102,97
2011,BA2  6,BA2  6,Total,3052,2866,186
2011,BA2  7,BA2  7,Total,2231,2063,168
2011,BA2  8,BA2  8,Total,3197,3118,79
2011,BA2  9,BA2  9,Total,687,649,38
2011,BA20 1,BA20 1,Total,1305,1140,165
2011,BA20 2,BA20 2,Total,3777,3641,136
2011,BA21 3,BA21 3,Total,6506,6345,161
2011,BA21 4,BA21 4,Total,4079,3867,212
2011,BA21 5,BA21 5,Total,4318,4129,189
2011,BA22 7,BA22 7,Total,1747,1626,121
2011,BA22 8,BA22 8,Total,3413,3251,162
2011,BA22 9,BA22 9,Total,2496,2373,123
2011,BA3  2,BA3  2,Total,4233,4125,108
2011,BA3  3,BA3  3,Total,4293,4192,101
2011,BA3  4,BA3  4,Total,2952,2840,112
2011,BA3  5,BA3  5,Total,2973,2834,139
2011,BA4  4,BA4  4,Total,2126,2037,89
2011,BA4  5,BA4  5,Total,3730,3556,174
2011,BA4  6,BA4  6,Total,1968,1851,117
2011,BA5  1,BA5  1,Total,2803,2633,170
2011,BA5  2,BA5  2,Total,3553,3372,181
2011,BA5  3,BA5  3,Total,1919,1825,94
2011,BA6  8,BA6  8,Total,2935,2757,178
2011,BA6  9,BA6  9,Total,3100,2889,211
2011,BA7  7,BA7  7,Total,1725,1603,122
2011,BA8  0,BA8  0,Total,1953,1791,162
2011,BA9  8,BA9  8,Total,700,636,64
2011,BA9  9,BA9  9,Total,2730,2555,175
2011,BB1  1,BB1  1,Total,4131,3983,148
2011,BB1  2,BB1  2,Total,3791,3675,116
2011,BB1  3,BB1  3,Total,1236,1191,45
2011,BB1  4,BB1  4,Total,3065,2912,153
2011,BB1  5,BB1  5,Total,2918,2785,133
2011,BB1  6,BB1  6,Total,968,905,63
2011,BB1  7,BB1  7,Total,1276,1195,81
2011,BB1  8,BB1  8,Total,3465,3304,161
2011,BB1  9,BB1  9,Total,4347,4166,181
2011,BB10 1,BB10 1,Total,3843,3347,496
2011,BB10 2,BB10 2,Total,4356,4234,122
2011,BB10 3,BB10 3,Total,3581,3345,236
2011,BB10 4,BB10 4,Total,5052,4881,171
2011,BB11 2,BB11 2,Total,2247,2102,145
2011,BB11 3,BB11 3,Total,2124,1953,171
2011,BB11 4,BB11 4,Total,2993,2729,264
2011,BB11 5,BB11 5,Total,3114,3001,113
2011,BB12 0,BB12 0,Total,3284,3103,181
2011,BB12 6,BB12 6,Total,4038,3853,185
2011,BB12 7,BB12 7,Total,3245,3091,154
2011,BB12 8,BB12 8,Total,3810,3580,230
2011,BB12 9,BB12 9,Total,1314,1298,16
2011,BB18 5,BB18 5,Total,3634,3423,211
2011,BB18 6,BB18 6,Total,4341,4120,221
2011,BB2  1,BB2  1,Total,2514,2369,145
2011,BB2  2,BB2  2,Total,2112,2029,83
2011,BB2  3,BB2  3,Total,4287,4175,112
2011,BB2  4,BB2  4,Total,6417,6332,85
2011,BB2  5,BB2  5,Total,3025,2989,36
2011,BB2  6,BB2  6,Total,3649,3365,284
2011,BB2  7,BB2  7,Total,2961,2859,102
2011,BB3  0,BB3  0,Total,3949,3869,80
2011,BB3  1,BB3  1,Total,2941,2835,106
2011,BB3  2,BB3  2,Total,4343,4138,205
2011,BB3  3,BB3  3,Total,4378,4102,276
2011,BB4  4,BB4  4,Total,3243,3112,131
2011,BB4  5,BB4  5,Total,2677,2507,170
2011,BB4  6,BB4  6,Total,3487,3330,157
2011,BB4  7,BB4  7,Total,2709,2542,167
2011,BB4  8,BB4  8,Total,3739,3534,205
2011,BB4  9,BB4  9,Total,2616,2472,144
2011,BB5  0,BB5  0,Total,3712,3505,207
2011,BB5  1,BB5  1,Total,2047,1878,169
2011,BB5  2,BB5  2,Total,3643,3370,273
2011,BB5  3,BB5  3,Total,3811,3650,161
2011,BB5  4,BB5  4,Total,3944,3845,99
2011,BB5  5,BB5  5,Total,5039,4850,189
2011,BB5  6,BB5  6,Total,4712,4591,121
2011,BB6  7,BB6  7,Total,5058,4788,270
2011,BB6  8,BB6  8,Total,1533,1485,48
2011,BB7  1,BB7  1,Total,3592,3448,144
2011,BB7  2,BB7  2,Total,3203,3111,92
2011,BB7  3,BB7  3,Total,1400,1304,96
2011,BB7  4,BB7  4,Total,2234,2120,114
2011,BB7  9,BB7  9,Total,3653,3547,106
2011,BB8  0,BB8  0,Total,3018,2841,177
2011,BB8  7,BB8  7,Total,2143,2046,97
2011,BB8  8,BB8  8,Total,2300,2196,104
2011,BB8  9,BB8  9,Total,3387,3217,170
2011,BB9  0,BB9  0,Total,5019,4703,316
2011,BB9  5,BB9  5,Total,2575,2434,141
2011,BB9  6,BB9  6,Total,2145,2100,45
2011,BB9  7,BB9  7,Total,2258,2145,113
2011,BB9  8,BB9  8,Total,3668,3554,114
2011,BB9  9,BB9  9,Total,2996,2693,303
2011,BD1  1,BD1  1,Total,263,241,22
2011,BD1  2,BD1  2,Total,326,235,91
2011,BD1  3,BD1  3,Total,463,438,25
2011,BD1  4,BD1  4,Total,462,454,8
2011,BD1  5,BD1  5,Total,509,475,34
2011,BD10 0,BD10 0,Total,3796,3713,83
2011,BD10 8,BD10 8,Total,4338,4223,115
2011,BD10 9,BD10 9,Total,2989,2927,62
2011,BD11 1,BD11 1,Total,2463,2386,77
2011,BD11 2,BD11 2,Total,2590,2482,108
2011,BD12 0,BD12 0,Total,2416,2349,67
2011,BD12 7,BD12 7,Total,877,830,47
2011,BD12 8,BD12 8,Total,2178,2093,85
2011,BD12 9,BD12 9,Total,2105,2033,72
2011,BD13 1,BD13 1,Total,1735,1671,64
2011,BD13 2,BD13 2,Total,3265,3158,107
2011,BD13 3,BD13 3,Total,3086,2910,176
2011,BD13 4,BD13 4,Total,1561,1481,80
2011,BD13 5,BD13 5,Total,1369,1297,72
2011,BD14 6,BD14 6,Total,3482,3391,91
2011,BD15 0,BD15 0,Total,1851,1795,56
2011,BD15 7,BD15 7,Total,3325,3129,196
2011,BD15 9,BD15 9,Total,1260,1228,32
2011,BD16 1,BD16 1,Total,4450,4234,216
2011,BD16 2,BD16 2,Total,1773,1710,63
2011,BD16 3,BD16 3,Total,2426,2368,58
2011,BD16 4,BD16 4,Total,3291,3159,132
2011,BD17 5,BD17 5,Total,3735,3566,169
2011,BD17 6,BD17 6,Total,2826,2750,76
2011,BD17 7,BD17 7,Total,1935,1791,144
2011,BD18 1,BD18 1,Total,2975,2899,76
2011,BD18 2,BD18 2,Total,3009,2884,125
2011,BD18 3,BD18 3,Total,2497,2336,161
2011,BD18 4,BD18 4,Total,3490,3343,147
2011,BD19 3,BD19 3,Total,2911,2735,176
2011,BD19 4,BD19 4,Total,4160,3999,161
2011,BD19 5,BD19 5,Total,1229,1169,60
2011,BD19 6,BD19 6,Total,1779,1727,52
2011,BD2  1,BD2  1,Total,3211,3137,74
2011,BD2  2,BD2  2,Total,2176,2125,51
2011,BD2  3,BD2  3,Total,3237,3186,51
2011,BD2  4,BD2  4,Total,2903,2856,47
2011,BD20 0,BD20 0,Total,2867,2740,127
2011,BD20 5,BD20 5,Total,3109,3020,89
2011,BD20 6,BD20 6,Total,3022,2882,140
2011,BD20 7,BD20 7,Total,2201,2089,112
2011,BD20 8,BD20 8,Total,2481,2354,127
2011,BD20 9,BD20 9,Total,1809,1739,70
2011,BD21 1,BD21 1,Total,2626,2474,152
2011,BD21 2,BD21 2,Total,2424,2262,162
2011,BD21 3,BD21 3,Total,1265,1143,122
2011,BD21 4,BD21 4,Total,2991,2859,132
2011,BD21 5,BD21 5,Total,1317,1232,85
2011,BD22 0,BD22 0,Total,1997,1853,144
2011,BD22 6,BD22 6,Total,3295,3163,132
2011,BD22 7,BD22 7,Total,3928,3801,127
2011,BD22 8,BD22 8,Total,2092,1964,128
2011,BD22 9,BD22 9,Total,2003,1915,88
2011,BD23 1,BD23 1,Total,2826,2662,164
2011,BD23 2,BD23 2,Total,4028,3845,183
2011,BD23 3,BD23 3,Total,2053,1859,194
2011,BD23 4,BD23 4,Total,1714,1498,216
2011,BD23 5,BD23 5,Total,1984,1621,363
2011,BD23 6,BD23 6,Total,1857,1676,181
2011,BD24 0,BD24 0,Total,934,797,137
2011,BD24 9,BD24 9,Total,1769,1530,239
2011,BD3  0,BD3  0,Total,3437,3286,151
2011,BD3  7,BD3  7,Total,2226,2130,96
2011,BD3  8,BD3  8,Total,2675,2527,148
2011,BD3  9,BD3  9,Total,2018,1921,97
2011,BD4  0,BD4  0,Total,2881,2750,131
2011,BD4  6,BD4  6,Total,3004,2874,130
2011,BD4  7,BD4  7,Total,1926,1831,95
2011,BD4  8,BD4  8,Total,2943,2795,148
2011,BD4  9,BD4  9,Total,2393,2296,97
2011,BD5  0,BD5  0,Total,2788,2656,132
2011,BD5  7,BD5  7,Total,2006,1921,85
2011,BD5  8,BD5  8,Total,2742,2644,98
2011,BD5  9,BD5  9,Total,3558,3424,134
2011,BD6  1,BD6  1,Total,4231,4123,108
2011,BD6  2,BD6  2,Total,3104,3049,55
2011,BD6  3,BD6  3,Total,5315,5176,139
2011,BD7  1,BD7  1,Total,1664,1460,204
2011,BD7  2,BD7  2,Total,3555,3375,180
2011,BD7  3,BD7  3,Total,2932,2724,208
2011,BD7  4,BD7  4,Total,3429,3306,123
2011,BD8  0,BD8  0,Total,2971,2813,158
2011,BD8  7,BD8  7,Total,2305,2229,76
2011,BD8  8,BD8  8,Total,1761,1692,69
2011,BD8  9,BD8  9,Total,3095,2882,213
2011,BD9  4,BD9  4,Total,2724,2563,161
2011,BD9  5,BD9  5,Total,2874,2728,146
2011,BD9  6,BD9  6,Total,2995,2857,138
2011,BH1  1,BH1  1,Total,1673,1551,122
2011,BH1  2,BH1  2,Total,685,595,90
2011,BH1  3,BH1  3,Total,3960,3341,619
2011,BH1  4,BH1  4,Total,4621,4418,203
2011,BH10 4,BH10 4,Total,1794,1749,45
2011,BH10 5,BH10 5,Total,3072,2999,73
2011,BH10 6,BH10 6,Total,2159,2124,35
2011,BH10 7,BH10 7,Total,1785,1741,44
2011,BH11 8,BH11 8,Total,4222,4137,85
2011,BH11 9,BH11 9,Total,4468,4398,70
2011,BH12 1,BH12 1,Total,2891,2818,73
2011,BH12 2,BH12 2,Total,3489,3399,90
2011,BH12 3,BH12 3,Total,3519,3447,72
2011,BH12 4,BH12 4,Total,3540,3473,67
2011,BH12 5,BH12 5,Total,1693,1669,24
2011,BH13 6,BH13 6,Total,2677,2392,285
2011,BH13 7,BH13 7,Total,2546,1874,672
2011,BH14 0,BH14 0,Total,3231,3095,136
2011,BH14 8,BH14 8,Total,4781,4419,362
2011,BH14 9,BH14 9,Total,3124,3008,116
2011,BH15 1,BH15 1,Total,3544,3050,494
2011,BH15 2,BH15 2,Total,2753,2615,138
2011,BH15 3,BH15 3,Total,4799,4698,101
2011,BH15 4,BH15 4,Total,4365,4156,209
2011,BH16 5,BH16 5,Total,4606,4495,111
2011,BH16 6,BH16 6,Total,2152,2061,91
2011,BH17 7,BH17 7,Total,3892,3847,45
2011,BH17 8,BH17 8,Total,3049,3021,28
2011,BH17 9,BH17 9,Total,2715,2686,29
2011,BH18 8,BH18 8,Total,2088,2035,53
2011,BH18 9,BH18 9,Total,2576,2541,35
2011,BH19 1,BH19 1,Total,2656,2006,650
2011,BH19 2,BH19 2,Total,3160,2498,662
2011,BH19 3,BH19 3,Total,1152,848,304
2011,BH2  5,BH2  5,Total,2922,2572,350
2011,BH2  6,BH2  6,Total,2349,2204,145
2011,BH20 4,BH20 4,Total,2691,2557,134
2011,BH20 5,BH20 5,Total,2067,1733,334
2011,BH20 6,BH20 6,Total,2376,2256,120
2011,BH20 7,BH20 7,Total,2037,1946,91
2011,BH21 1,BH21 1,Total,4939,4807,132
2011,BH21 2,BH21 2,Total,3818,3759,59
2011,BH21 3,BH21 3,Total,4202,4128,74
2011,BH21 4,BH21 4,Total,862,848,14
2011,BH21 5,BH21 5,Total,1054,978,76
2011,BH21 6,BH21 6,Total,593,560,33
2011,BH21 7,BH21 7,Total,1651,1586,65
2011,BH21 8,BH21 8,Total,213,201,12
2011,BH22 0,BH22 0,Total,3657,3492,165
2011,BH22 8,BH22 8,Total,4846,4673,173
2011,BH22 9,BH22 9,Total,4219,4034,185
2011,BH23 1,BH23 1,Total,3017,2701,316
2011,BH23 2,BH23 2,Total,5164,4931,233
2011,BH23 3,BH23 3,Total,4258,3955,303
2011,BH23 4,BH23 4,Total,4978,4600,378
2011,BH23 5,BH23 5,Total,3715,3373,342
2011,BH23 6,BH23 6,Total,204,184,20
2011,BH23 7,BH23 7,Total,1907,1831,76
2011,BH23 8,BH23 8,Total,2021,1962,59
2011,BH24 1,BH24 1,Total,4650,4520,130
2011,BH24 2,BH24 2,Total,3208,3040,168
2011,BH24 3,BH24 3,Total,2080,1990,90
2011,BH24 4,BH24 4,Total,672,585,87
2011,BH25 5,BH25 5,Total,5593,5410,183
2011,BH25 6,BH25 6,Total,3353,3206,147
2011,BH25 7,BH25 7,Total,3531,3300,231
2011,BH3  7,BH3  7,Total,2379,2295,84
2011,BH31 6,BH31 6,Total,4352,4182,170
2011,BH31 7,BH31 7,Total,1363,1319,44
2011,BH4  8,BH4  8,Total,3333,2935,398
2011,BH4  9,BH4  9,Total,2295,2186,109
2011,BH5  1,BH5  1,Total,3998,3519,479
2011,BH5  2,BH5  2,Total,2263,2125,138
2011,BH6  3,BH6  3,Total,4581,4283,298
2011,BH6  4,BH6  4,Total,2009,1811,198
2011,BH6  5,BH6  5,Total,4092,3964,128
2011,BH7  6,BH7  6,Total,3603,3473,130
2011,BH7  7,BH7  7,Total,1597,1492,105
2011,BH8  0,BH8  0,Total,3088,3041,47
2011,BH8  8,BH8  8,Total,5730,5457,273
2011,BH8  9,BH8  9,Total,3559,3466,93
2011,BH9  1,BH9  1,Total,4905,4771,134
2011,BH9  2,BH9  2,Total,3410,3312,98
2011,BH9  3,BH9  3,Total,4187,4111,76
2011,BL0  0,BL0  0,Total,2590,2469,121
2011,BL0  9,BL0  9,Total,5438,5239,199
2011,BL1  1,BL1  1,Total,230,218,12
2011,BL1  2,BL1  2,Total,2233,2136,97
2011,BL1  3,BL1  3,Total,4441,4254,187
2011,BL1  4,BL1  4,Total,4233,3947,286
2011,BL1  5,BL1  5,Total,5213,5006,207
2011,BL1  6,BL1  6,Total,3879,3727,152
2011,BL1  7,BL1  7,Total,3648,3541,107
2011,BL1  8,BL1  8,Total,4619,4415,204
2011,BL2  1,BL2  1,Total,1837,1695,142
2011,BL2  2,BL2  2,Total,4025,3826,199
2011,BL2  3,BL2  3,Total,3878,3749,129
2011,BL2  4,BL2  4,Total,2060,1993,67
2011,BL2  5,BL2  5,Total,4159,4006,153
2011,BL2  6,BL2  6,Total,4772,4591,181
2011,BL3  1,BL3  1,Total,5403,5265,138
2011,BL3  2,BL3  2,Total,3718,3485,233
2011,BL3  3,BL3  3,Total,5950,5678,272
2011,BL3  4,BL3  4,Total,6027,5775,252
2011,BL3  5,BL3  5,Total,3151,3023,128
2011,BL3  6,BL3  6,Total,2044,1944,100
2011,BL4  0,BL4  0,Total,4112,3999,113
2011,BL4  7,BL4  7,Total,3223,3049,174
2011,BL4  8,BL4  8,Total,3636,3500,136
2011,BL4  9,BL4  9,Total,3877,3723,154
2011,BL5  1,BL5  1,Total,1213,1184,29
2011,BL5  2,BL5  2,Total,5222,5073,149
2011,BL5  3,BL5  3,Total,5374,5247,127
2011,BL6  4,BL6  4,Total,2402,2357,45
2011,BL6  5,BL6  5,Total,4474,4322,152
2011,BL6  6,BL6  6,Total,3156,3059,97
2011,BL6  7,BL6  7,Total,3033,2952,81
2011,BL7  0,BL7  0,Total,1376,1325,51
2011,BL7  8,BL7  8,Total,317,300,17
2011,BL7  9,BL7  9,Total,4882,4760,122
2011,BL8  1,BL8  1,Total,5481,5309,172
2011,BL8  2,BL8  2,Total,4633,4466,167
2011,BL8  3,BL8  3,Total,3501,3359,142
2011,BL8  4,BL8  4,Total,1820,1752,68
2011,BL9  0,BL9  0,Total,1095,1039,56
2011,BL9  5,BL9  5,Total,2865,2716,149
2011,BL9  6,BL9  6,Total,4096,3916,180
2011,BL9  7,BL9  7,Total,4460,4279,181
2011,BL9  8,BL9  8,Total,4059,3962,97
2011,BL9  9,BL9  9,Total,4649,4536,113
2011,BN1  1,BN1  1,Total,1117,1008,109
2011,BN1  2,BN1  2,Total,3152,2878,274
2011,BN1  3,BN1  3,Total,5991,5735,256
2011,BN1  4,BN1  4,Total,4201,4011,190
2011,BN1  5,BN1  5,Total,4465,4314,151
2011,BN1  6,BN1  6,Total,7710,7480,230
2011,BN1  7,BN1  7,Total,3353,3305,48
2011,BN1  8,BN1  8,Total,6032,5928,104
2011,BN1  9,BN1  9,Total,1883,1850,33
2011,BN10 7,BN10 7,Total,4035,3932,103
2011,BN10 8,BN10 8,Total,4291,4171,120
2011,BN11 1,BN11 1,Total,2433,2264,169
2011,BN11 2,BN11 2,Total,4420,4209,211
2011,BN11 3,BN11 3,Total,2756,2499,257
2011,BN11 4,BN11 4,Total,4631,4403,228
2011,BN11 5,BN11 5,Total,3095,3003,92
2011,BN12 4,BN12 4,Total,3593,3523,70
2011,BN12 5,BN12 5,Total,2425,2288,137
2011,BN12 6,BN12 6,Total,3514,3461,53
2011,BN13 1,BN13 1,Total,3715,3628,87
2011,BN13 2,BN13 2,Total,4718,4608,110
2011,BN13 3,BN13 3,Total,3704,3620,84
2011,BN14 0,BN14 0,Total,2707,2621,86
2011,BN14 7,BN14 7,Total,4591,4471,120
2011,BN14 8,BN14 8,Total,2800,2738,62
2011,BN14 9,BN14 9,Total,3145,3078,67
2011,BN15 0,BN15 0,Total,3605,3535,70
2011,BN15 8,BN15 8,Total,4058,3913,145
2011,BN15 9,BN15 9,Total,4870,4773,97
2011,BN16 1,BN16 1,Total,3239,3064,175
2011,BN16 2,BN16 2,Total,3801,3523,278
2011,BN16 3,BN16 3,Total,3908,3783,125
2011,BN16 4,BN16 4,Total,2886,2808,78
2011,BN17 5,BN17 5,Total,3584,3264,320
2011,BN17 6,BN17 6,Total,5872,5747,125
2011,BN17 7,BN17 7,Total,3479,3406,73
2011,BN18 0,BN18 0,Total,3484,3351,133
2011,BN18 9,BN18 9,Total,2554,2308,246
2011,BN2  0,BN2  0,Total,3451,3339,112
2011,BN2  1,BN2  1,Total,6540,5946,594
2011,BN2  3,BN2  3,Total,5322,5127,195
2011,BN2  4,BN2  4,Total,6095,6005,90
2011,BN2  5,BN2  5,Total,6113,5741,372
2011,BN2  6,BN2  6,Total,3996,3924,72
2011,BN2  7,BN2  7,Total,2093,1967,126
2011,BN2  8,BN2  8,Total,4049,3852,197
2011,BN2  9,BN2  9,Total,4886,4789,97
2011,BN20 0,BN20 0,Total,824,772,52
2011,BN20 7,BN20 7,Total,3310,2940,370
2011,BN20 8,BN20 8,Total,3539,3471,68
2011,BN20 9,BN20 9,Total,2388,2333,55
2011,BN21 1,BN21 1,Total,3501,3340,161
2011,BN21 2,BN21 2,Total,4631,4362,269
2011,BN21 3,BN21 3,Total,3110,2797,313
2011,BN21 4,BN21 4,Total,2614,2307,307
2011,BN22 0,BN22 0,Total,4165,4074,91
2011,BN22 7,BN22 7,Total,2455,2263,192
2011,BN22 8,BN22 8,Total,4462,4300,162
2011,BN22 9,BN22 9,Total,3235,3153,82
2011,BN23 5,BN23 5,Total,3459,2965,494
2011,BN23 6,BN23 6,Total,3155,3023,132
2011,BN23 7,BN23 7,Total,3515,3402,113
2011,BN23 8,BN23 8,Total,3212,3124,88
2011,BN24 5,BN24 5,Total,2621,2537,84
2011,BN24 6,BN24 6,Total,1756,1540,216
2011,BN25 1,BN25 1,Total,2568,2344,224
2011,BN25 2,BN25 2,Total,3471,3335,136
2011,BN25 3,BN25 3,Total,3928,3838,90
2011,BN25 4,BN25 4,Total,1326,1277,49
2011,BN26 5,BN26 5,Total,3136,2988,148
2011,BN26 6,BN26 6,Total,2566,2452,114
2011,BN27 1,BN27 1,Total,2762,2669,93
2011,BN27 2,BN27 2,Total,2311,2232,79
2011,BN27 3,BN27 3,Total,4742,4633,109
2011,BN27 4,BN27 4,Total,1890,1785,105
2011,BN3  1,BN3  1,Total,6238,5775,463
2011,BN3  2,BN3  2,Total,4355,4018,337
2011,BN3  3,BN3  3,Total,7610,7192,418
2011,BN3  4,BN3  4,Total,3731,3535,196
2011,BN3  5,BN3  5,Total,5426,5216,210
2011,BN3  6,BN3  6,Total,4769,4602,167
2011,BN3  7,BN3  7,Total,4089,4011,78
2011,BN3  8,BN3  8,Total,3447,3375,72
2011,BN41 1,BN41 1,Total,2782,2691,91
2011,BN41 2,BN41 2,Total,5972,5887,85
2011,BN42 4,BN42 4,Total,4299,4225,74
2011,BN43 5,BN43 5,Total,5393,5201,192
2011,BN43 6,BN43 6,Total,4894,4768,126
2011,BN44 3,BN44 3,Total,4581,4416,165
2011,BN45 7,BN45 7,Total,284,273,11
2011,BN5  9,BN5  9,Total,3144,3051,93
2011,BN6  8,BN6  8,Total,3895,3794,101
2011,BN6  9,BN6  9,Total,3559,3480,79
2011,BN7  1,BN7  1,Total,3621,3504,117
2011,BN7  2,BN7  2,Total,3987,3832,155
2011,BN7  3,BN7  3,Total,1669,1626,43
2011,BN8  4,BN8  4,Total,2450,2361,89
2011,BN8  5,BN8  5,Total,2646,2577,69
2011,BN8  6,BN8  6,Total,1762,1673,89
2011,BN9  0,BN9  0,Total,1680,1650,30
2011,BN9  9,BN9  9,Total,4335,4166,169
2011,BR1  1,BR1  1,Total,269,239,30
2011,BR1  2,BR1  2,Total,4674,4537,137
2011,BR1  3,BR1  3,Total,6111,5760,351
2011,BR1  4,BR1  4,Total,6193,5999,194
2011,BR1  5,BR1  5,Total,7003,6832,171
2011,BR2  0,BR2  0,Total,5636,5476,160
2011,BR2  6,BR2  6,Total,988,944,44
2011,BR2  7,BR2  7,Total,3576,3495,81
2011,BR2  8,BR2  8,Total,4552,4341,211
2011,BR2  9,BR2  9,Total,4995,4746,249
2011,BR3  1,BR3  1,Total,4645,4491,154
2011,BR3  3,BR3  3,Total,5027,4905,122
2011,BR3  4,BR3  4,Total,5888,5711,177
2011,BR3  5,BR3  5,Total,3743,3586,157
2011,BR3  6,BR3  6,Total,2463,2400,63
2011,BR4  0,BR4  0,Total,3430,3345,85
2011,BR4  9,BR4  9,Total,3969,3869,100
2011,BR5  1,BR5  1,Total,4784,4684,100
2011,BR5  2,BR5  2,Total,5415,5279,136
2011,BR5  3,BR5  3,Total,4512,4410,102
2011,BR5  4,BR5  4,Total,4534,4421,113
2011,BR6  0,BR6  0,Total,4125,4010,115
2011,BR6  6,BR6  6,Total,2716,2656,60
2011,BR6  7,BR6  7,Total,3501,3424,77
2011,BR6  8,BR6  8,Total,3460,3292,168
2011,BR6  9,BR6  9,Total,6012,5920,92
2011,BR7  5,BR7  5,Total,3032,2845,187
2011,BR7  6,BR7  6,Total,4398,4228,170
2011,BR8  7,BR8  7,Total,6373,6320,53
2011,BR8  8,BR8  8,Total,2887,2835,52
2011,BS1  1,BS1  1,Total,462,431,31
2011,BS1  2,BS1  2,Total,112,108,4
2011,BS1  3,BS1  3,Total,942,836,106
2011,BS1  4,BS1  4,Total,345,304,41
2011,BS1  5,BS1  5,Total,1624,1471,153
2011,BS1  6,BS1  6,Total,2591,2380,211
2011,BS10 5,BS10 5,Total,3852,3737,115
2011,BS10 6,BS10 6,Total,4602,4453,149
2011,BS10 7,BS10 7,Total,3663,3557,106
2011,BS11 0,BS11 0,Total,4321,4202,119
2011,BS11 9,BS11 9,Total,3397,3226,171
2011,BS13 0,BS13 0,Total,3304,3227,77
2011,BS13 7,BS13 7,Total,3562,3452,110
2011,BS13 8,BS13 8,Total,3315,3182,133
2011,BS13 9,BS13 9,Total,2829,2697,132
2011,BS14 0,BS14 0,Total,3609,3517,92
2011,BS14 8,BS14 8,Total,3487,3411,76
2011,BS14 9,BS14 9,Total,5093,4956,137
2011,BS15 1,BS15 1,Total,5262,5070,192
2011,BS15 3,BS15 3,Total,3784,3692,92
2011,BS15 4,BS15 4,Total,4887,4791,96
2011,BS15 8,BS15 8,Total,3388,3224,164
2011,BS15 9,BS15 9,Total,3434,3352,82
2011,BS16 1,BS16 1,Total,4431,4235,196
2011,BS16 2,BS16 2,Total,4103,3906,197
2011,BS16 3,BS16 3,Total,3074,2926,148
2011,BS16 4,BS16 4,Total,3915,3770,145
2011,BS16 5,BS16 5,Total,4695,4527,168
2011,BS16 6,BS16 6,Total,4408,4309,99
2011,BS16 7,BS16 7,Total,3054,3007,47
2011,BS16 9,BS16 9,Total,4181,4110,71
2011,BS2  0,BS2  0,Total,1672,1598,74
2011,BS2  8,BS2  8,Total,2825,2691,134
2011,BS2  9,BS2  9,Total,3020,2905,115
2011,BS20 0,BS20 0,Total,2168,2107,61
2011,BS20 6,BS20 6,Total,3708,3607,101
2011,BS20 7,BS20 7,Total,4984,4838,146
2011,BS20 8,BS20 8,Total,2576,2528,48
2011,BS21 5,BS21 5,Total,2137,2101,36
2011,BS21 6,BS21 6,Total,3948,3836,112
2011,BS21 7,BS21 7,Total,4491,4280,211
2011,BS22 6,BS22 6,Total,3726,3651,75
2011,BS22 7,BS22 7,Total,4229,4170,59
2011,BS22 8,BS22 8,Total,4913,4765,148
2011,BS22 9,BS22 9,Total,3748,3652,96
2011,BS23 1,BS23 1,Total,2876,2553,323
2011,BS23 2,BS23 2,Total,5187,4676,511
2011,BS23 3,BS23 3,Total,5966,5544,422
2011,BS23 4,BS23 4,Total,3703,3470,233
2011,BS24 0,BS24 0,Total,887,830,57
2011,BS24 6,BS24 6,Total,143,137,6
2011,BS24 7,BS24 7,Total,3286,3219,67
2011,BS24 8,BS24 8,Total,1030,987,43
2011,BS24 9,BS24 9,Total,2773,2662,111
2011,BS25 1,BS25 1,Total,2055,1948,107
2011,BS25 5,BS25 5,Total,715,664,51
2011,BS26 2,BS26 2,Total,2174,2070,104
2011,BS27 3,BS27 3,Total,3105,2975,130
2011,BS28 4,BS28 4,Total,1388,1330,58
2011,BS29 6,BS29 6,Total,1336,1265,71
2011,BS3  1,BS3  1,Total,4163,4048,115
2011,BS3  2,BS3  2,Total,2745,2629,116
2011,BS3  3,BS3  3,Total,3179,3053,126
2011,BS3  4,BS3  4,Total,3834,3676,158
2011,BS3  5,BS3  5,Total,3541,3363,178
2011,BS30 5,BS30 5,Total,2029,1994,35
2011,BS30 6,BS30 6,Total,1469,1430,39
2011,BS30 7,BS30 7,Total,1491,1478,13
2011,BS30 8,BS30 8,Total,4414,4339,75
2011,BS30 9,BS30 9,Total,3363,3280,83
2011,BS31 1,BS31 1,Total,3487,3378,109
2011,BS31 2,BS31 2,Total,3635,3546,89
2011,BS31 3,BS31 3,Total,1715,1680,35
2011,BS32 0,BS32 0,Total,3079,3008,71
2011,BS32 4,BS32 4,Total,1790,1722,68
2011,BS32 8,BS32 8,Total,3368,3304,64
2011,BS32 9,BS32 9,Total,2028,1962,66
2011,BS34 5,BS34 5,Total,3551,3460,91
2011,BS34 6,BS34 6,Total,2749,2702,47
2011,BS34 7,BS34 7,Total,3074,2990,84
2011,BS34 8,BS34 8,Total,3467,3411,56
2011,BS35 1,BS35 1,Total,2832,2777,55
2011,BS35 2,BS35 2,Total,2766,2702,64
2011,BS35 3,BS35 3,Total,1371,1335,36
2011,BS35 4,BS35 4,Total,2070,2026,44
2011,BS35 5,BS35 5,Total,269,257,12
2011,BS36 1,BS36 1,Total,2591,2544,47
2011,BS36 2,BS36 2,Total,3757,3694,63
2011,BS37 4,BS37 4,Total,3465,3426,39
2011,BS37 5,BS37 5,Total,3306,3261,45
2011,BS37 6,BS37 6,Total,3468,3387,81
2011,BS37 7,BS37 7,Total,2628,2595,33
2011,BS37 8,BS37 8,Total,2479,2445,34
2011,BS37 9,BS37 9,Total,334,323,11
2011,BS39 4,BS39 4,Total,1039,991,48
2011,BS39 5,BS39 5,Total,1811,1763,48
2011,BS39 6,BS39 6,Total,1222,1186,36
2011,BS39 7,BS39 7,Total,2263,2185,78
2011,BS4  1,BS4  1,Total,5141,4960,181
2011,BS4  2,BS4  2,Total,4302,4173,129
2011,BS4  3,BS4  3,Total,4103,3973,130
2011,BS4  4,BS4  4,Total,5583,5436,147
2011,BS4  5,BS4  5,Total,1614,1580,34
2011,BS40 5,BS40 5,Total,1929,1858,71
2011,BS40 6,BS40 6,Total,965,920,45
2011,BS40 7,BS40 7,Total,710,679,31
2011,BS40 8,BS40 8,Total,1625,1552,73
2011,BS40 9,BS40 9,Total,279,258,21
2011,BS41 8,BS41 8,Total,348,326,22
2011,BS41 9,BS41 9,Total,2233,2161,72
2011,BS48 1,BS48 1,Total,2387,2325,62
2011,BS48 2,BS48 2,Total,3061,2999,62
2011,BS48 3,BS48 3,Total,2264,2196,68
2011,BS48 4,BS48 4,Total,2351,2321,30
2011,BS49 4,BS49 4,Total,3495,3422,73
2011,BS49 5,BS49 5,Total,1475,1422,53
2011,BS5  0,BS5  0,Total,3881,3734,147
2011,BS5  6,BS5  6,Total,5672,5465,207
2011,BS5  7,BS5  7,Total,4995,4829,166
2011,BS5  8,BS5  8,Total,4571,4353,218
2011,BS5  9,BS5  9,Total,4500,4378,122
2011,BS6  5,BS6  5,Total,4862,4689,173
2011,BS6  6,BS6  6,Total,5673,5445,228
2011,BS6  7,BS6  7,Total,4040,3909,131
2011,BS7  0,BS7  0,Total,6542,6357,185
2011,BS7  8,BS7  8,Total,4080,3937,143
2011,BS7  9,BS7  9,Total,6204,6043,161
2011,BS8  1,BS8  1,Total,2110,1986,124
2011,BS8  2,BS8  2,Total,3416,3240,176
2011,BS8  3,BS8  3,Total,2444,2303,141
2011,BS8  4,BS8  4,Total,4401,4183,218
2011,BS9  1,BS9  1,Total,2959,2853,106
2011,BS9  2,BS9  2,Total,2874,2803,71
2011,BS9  3,BS9  3,Total,3607,3511,96
2011,BS9  4,BS9  4,Total,3326,3204,122
2011,CA1  1,CA1  1,Total,1286,1169,117
2011,CA1  2,CA1  2,Total,5446,5170,276
2011,CA1  3,CA1  3,Total,5016,4823,193
2011,CA10 1,CA10 1,Total,2622,2409,213
2011,CA10 2,CA10 2,Total,1657,1418,239
2011,CA10 3,CA10 3,Total,2205,1946,259
2011,CA11 0,CA11 0,Total,2243,1847,396
2011,CA11 7,CA11 7,Total,1828,1745,83
2011,CA11 8,CA11 8,Total,3665,3564,101
2011,CA11 9,CA11 9,Total,2854,2745,109
2011,CA12 4,CA12 4,Total,2542,2046,496
2011,CA12 5,CA12 5,Total,1995,1474,521
2011,CA13 0,CA13 0,Total,4023,3737,286
2011,CA13 9,CA13 9,Total,3169,2917,252
2011,CA14 1,CA14 1,Total,3728,3628,100
2011,CA14 2,CA14 2,Total,2641,2506,135
2011,CA14 3,CA14 3,Total,3978,3878,100
2011,CA14 4,CA14 4,Total,2935,2812,123
2011,CA14 5,CA14 5,Total,3285,3199,86
2011,CA15 6,CA15 6,Total,2199,2016,183
2011,CA15 7,CA15 7,Total,2970,2871,99
2011,CA15 8,CA15 8,Total,2269,2169,100
2011,CA16 6,CA16 6,Total,3012,2758,254
2011,CA17 4,CA17 4,Total,2451,2152,299
2011,CA18 1,CA18 1,Total,190,157,33
2011,CA19 1,CA19 1,Total,557,454,103
2011,CA2  4,CA2  4,Total,4773,4611,162
2011,CA2  5,CA2  5,Total,3921,3746,175
2011,CA2  6,CA2  6,Total,4509,4409,100
2011,CA2  7,CA2  7,Total,5645,5360,285
2011,CA20 1,CA20 1,Total,1688,1532,156
2011,CA21 2,CA21 2,Total,480,443,37
2011,CA22 2,CA22 2,Total,4067,3898,169
2011,CA23 3,CA23 3,Total,682,628,54
2011,CA24 3,CA24 3,Total,546,528,18
2011,CA25 5,CA25 5,Total,2842,2711,131
2011,CA26 3,CA26 3,Total,1845,1707,138
2011,CA27 0,CA27 0,Total,741,676,65
2011,CA28 6,CA28 6,Total,4180,4075,105
2011,CA28 7,CA28 7,Total,1748,1599,149
2011,CA28 8,CA28 8,Total,3792,3669,123
2011,CA28 9,CA28 9,Total,3129,3014,115
2011,CA3  0,CA3  0,Total,2719,2666,53
2011,CA3  8,CA3  8,Total,174,153,21
2011,CA3  9,CA3  9,Total,3430,3317,113
2011,CA4  0,CA4  0,Total,1419,1352,67
2011,CA4  8,CA4  8,Total,2587,2511,76
2011,CA4  9,CA4  9,Total,386,358,28
2011,CA5  6,CA5  6,Total,1637,1581,56
2011,CA5  7,CA5  7,Total,1492,1415,77
2011,CA6  4,CA6  4,Total,1759,1697,62
2011,CA6  5,CA6  5,Total,1565,1497,68
2011,CA6  6,CA6  6,Total,702,651,51
2011,CA7  0,CA7  0,Total,720,683,37
2011,CA7  1,CA7  1,Total,732,638,94
2011,CA7  2,CA7  2,Total,1228,1147,81
2011,CA7  3,CA7  3,Total,1376,1291,85
2011,CA7  4,CA7  4,Total,1926,1793,133
2011,CA7  5,CA7  5,Total,877,824,53
2011,CA7  8,CA7  8,Total,866,774,92
2011,CA7  9,CA7  9,Total,2645,2515,130
2011,CA8  1,CA8  1,Total,2279,2155,124
2011,CA8  2,CA8  2,Total,876,811,65
2011,CA8  7,CA8  7,Total,730,643,87
2011,CA8  9,CA8  9,Total,994,955,39
2011,CA9  3,CA9  3,Total,1156,996,160
2011,CB1  1,CB1  1,Total,1700,1596,104
2011,CB1  2,CB1  2,Total,3246,3099,147
2011,CB1  3,CB1  3,Total,7969,7748,221
2011,CB1  7,CB1  7,Total,1757,1680,77
2011,CB1  8,CB1  8,Total,2284,2231,53
2011,CB1  9,CB1  9,Total,3954,3860,94
2011,CB10 1,CB10 1,Total,2176,2044,132
2011,CB10 2,CB10 2,Total,3493,3376,117
2011,CB11 3,CB11 3,Total,4094,3927,167
2011,CB11 4,CB11 4,Total,3413,3295,118
2011,CB2  0,CB2  0,Total,895,627,268
2011,CB2  1,CB2  1,Total,1105,1027,78
2011,CB2  3,CB2  3,Total,168,145,23
2011,CB2  7,CB2  7,Total,66,62,4
2011,CB2  8,CB2  8,Total,1471,1378,93
2011,CB2  9,CB2  9,Total,1437,1375,62
2011,CB21 4,CB21 4,Total,3503,3421,82
2011,CB21 5,CB21 5,Total,2339,2287,52
2011,CB21 6,CB21 6,Total,682,655,27
2011,CB22 3,CB22 3,Total,3322,3251,71
2011,CB22 4,CB22 4,Total,1803,1750,53
2011,CB22 5,CB22 5,Total,3392,3292,100
2011,CB22 6,CB22 6,Total,492,483,9
2011,CB22 7,CB22 7,Total,1317,1284,33
2011,CB23 1,CB23 1,Total,1108,1084,24
2011,CB23 2,CB23 2,Total,835,800,35
2011,CB23 3,CB23 3,Total,1401,1363,38
2011,CB23 4,CB23 4,Total,472,456,16
2011,CB23 5,CB23 5,Total,828,815,13
2011,CB23 6,CB23 6,Total,2266,2149,117
2011,CB23 7,CB23 7,Total,3442,3359,83
2011,CB23 8,CB23 8,Total,2169,2131,38
2011,CB24 3,CB24 3,Total,1795,1719,76
2011,CB24 4,CB24 4,Total,1368,1343,25
2011,CB24 5,CB24 5,Total,2826,2750,76
2011,CB24 6,CB24 6,Total,1765,1725,40
2011,CB24 8,CB24 8,Total,2729,2658,71
2011,CB24 9,CB24 9,Total,3336,3242,94
2011,CB25 0,CB25 0,Total,3516,3413,103
2011,CB25 9,CB25 9,Total,4053,3885,168
2011,CB3  0,CB3  0,Total,3130,2954,176
2011,CB3  9,CB3  9,Total,1684,1568,116
2011,CB4  1,CB4  1,Total,7243,6935,308
2011,CB4  2,CB4  2,Total,6101,5930,171
2011,CB4  3,CB4  3,Total,5135,4950,185
2011,CB5  8,CB5  8,Total,4799,4652,147
2011,CB6  1,CB6  1,Total,5422,5210,212
2011,CB6  2,CB6  2,Total,4859,4744,115
2011,CB6  3,CB6  3,Total,5771,5633,138
2011,CB7  4,CB7  4,Total,4089,3874,215
2011,CB7  5,CB7  5,Total,7660,7376,284
2011,CB8  0,CB8  0,Total,4485,4284,201
2011,CB8  7,CB8  7,Total,2992,2841,151
2011,CB8  8,CB8  8,Total,4364,4106,258
2011,CB8  9,CB8  9,Total,3070,2934,136
2011,CB9  0,CB9  0,Total,3312,3273,39
2011,CB9  7,CB9  7,Total,3966,3841,125
2011,CB9  8,CB9  8,Total,2488,2430,58
2011,CB9  9,CB9  9,Total,3498,3449,49
2011,CH1  1,CH1  1,Total,662,522,140
2011,CH1  2,CH1  2,Total,731,536,195
2011,CH1  3,CH1  3,Total,2279,2120,159
2011,CH1  4,CH1  4,Total,2970,2624,346
2011,CH1  5,CH1  5,Total,5986,5731,255
2011,CH1  6,CH1  6,Total,2090,2022,68
2011,CH2  1,CH2  1,Total,4202,3986,216
2011,CH2  2,CH2  2,Total,3669,3524,145
2011,CH2  3,CH2  3,Total,4490,4284,206
2011,CH2  4,CH2  4,Total,3147,3055,92
2011,CH3  5,CH3  5,Total,5777,5507,270
2011,CH3  6,CH3  6,Total,2137,2060,77
2011,CH3  7,CH3  7,Total,2910,2812,98
2011,CH3  8,CH3  8,Total,1711,1649,62
2011,CH3  9,CH3  9,Total,1813,1742,71
2011,CH4  0,CH4  0,Total,4398,4287,111
2011,CH4  7,CH4  7,Total,3469,3299,170
2011,CH4  8,CH4  8,Total,5115,4943,172
2011,CH4  9,CH4  9,Total,1474,1425,49
2011,CH41 0,CH41 0,Total,1640,1581,59
2011,CH41 1,CH41 1,Total,365,338,27
2011,CH41 2,CH41 2,Total,1516,1450,66
2011,CH41 3,CH41 3,Total,772,720,52
2011,CH41 4,CH41 4,Total,1483,1415,68
2011,CH41 5,CH41 5,Total,552,495,57
2011,CH41 6,CH41 6,Total,138,125,13
2011,CH41 7,CH41 7,Total,1095,1043,52
2011,CH41 8,CH41 8,Total,1344,1232,112
2011,CH41 9,CH41 9,Total,866,828,38
2011,CH42 0,CH42 0,Total,1244,1170,74
2011,CH42 1,CH42 1,Total,1565,1499,66
2011,CH42 2,CH42 2,Total,1069,967,102
2011,CH42 3,CH42 3,Total,1265,1208,57
2011,CH42 4,CH42 4,Total,1939,1849,90
2011,CH42 5,CH42 5,Total,1528,1448,80
2011,CH42 6,CH42 6,Total,1895,1832,63
2011,CH42 7,CH42 7,Total,1078,1027,51
2011,CH42 8,CH42 8,Total,1037,987,50
2011,CH42 9,CH42 9,Total,1767,1687,80
2011,CH43 0,CH43 0,Total,2154,2118,36
2011,CH43 1,CH43 1,Total,1526,1420,106
2011,CH43 2,CH43 2,Total,2115,1989,126
2011,CH43 3,CH43 3,Total,1209,1176,33
2011,CH43 4,CH43 4,Total,1490,1406,84
2011,CH43 5,CH43 5,Total,1867,1790,77
2011,CH43 6,CH43 6,Total,899,840,59
2011,CH43 7,CH43 7,Total,2397,2331,66
2011,CH43 8,CH43 8,Total,833,801,32
2011,CH43 9,CH43 9,Total,3325,3251,74
2011,CH44 0,CH44 0,Total,1401,1343,58
2011,CH44 1,CH44 1,Total,1199,1172,27
2011,CH44 2,CH44 2,Total,1190,1159,31
2011,CH44 3,CH44 3,Total,1049,1024,25
2011,CH44 4,CH44 4,Total,1935,1871,64
2011,CH44 5,CH44 5,Total,1499,1449,50
2011,CH44 6,CH44 6,Total,1243,1195,48
2011,CH44 7,CH44 7,Total,968,916,52
2011,CH44 8,CH44 8,Total,1517,1432,85
2011,CH44 9,CH44 9,Total,1642,1556,86
2011,CH45 0,CH45 0,Total,713,685,28
2011,CH45 1,CH45 1,Total,1366,1302,64
2011,CH45 2,CH45 2,Total,1520,1441,79
2011,CH45 3,CH45 3,Total,1193,1149,44
2011,CH45 4,CH45 4,Total,1767,1705,62
2011,CH45 5,CH45 5,Total,2007,1931,76
2011,CH45 6,CH45 6,Total,1055,1018,37
2011,CH45 7,CH45 7,Total,1537,1478,59
2011,CH45 8,CH45 8,Total,1997,1938,59
2011,CH45 9,CH45 9,Total,1080,1026,54
2011,CH46 0,CH46 0,Total,1669,1631,38
2011,CH46 1,CH46 1,Total,1111,1082,29
2011,CH46 2,CH46 2,Total,1209,1175,34
2011,CH46 3,CH46 3,Total,811,795,16
2011,CH46 5,CH46 5,Total,244,236,8
2011,CH46 6,CH46 6,Total,2348,2296,52
2011,CH46 7,CH46 7,Total,1273,1229,44
2011,CH46 8,CH46 8,Total,1389,1348,41
2011,CH46 9,CH46 9,Total,1402,1369,33
2011,CH47 0,CH47 0,Total,248,245,3
2011,CH47 1,CH47 1,Total,296,276,20
2011,CH47 2,CH47 2,Total,1018,965,53
2011,CH47 3,CH47 3,Total,1036,990,46
2011,CH47 4,CH47 4,Total,466,440,26
2011,CH47 5,CH47 5,Total,289,286,3
2011,CH47 6,CH47 6,Total,372,362,10
2011,CH47 7,CH47 7,Total,499,486,13
2011,CH47 9,CH47 9,Total,540,525,15
2011,CH48 0,CH48 0,Total,932,862,70
2011,CH48 1,CH48 1,Total,358,346,12
2011,CH48 2,CH48 2,Total,576,547,29
2011,CH48 3,CH48 3,Total,719,670,49
2011,CH48 4,CH48 4,Total,437,408,29
2011,CH48 5,CH48 5,Total,1196,1146,50
2011,CH48 6,CH48 6,Total,905,890,15
2011,CH48 7,CH48 7,Total,255,239,16
2011,CH48 8,CH48 8,Total,540,522,18
2011,CH48 9,CH48 9,Total,1024,1003,21
2011,CH49 0,CH49 0,Total,860,833,27
2011,CH49 1,CH49 1,Total,997,984,13
2011,CH49 2,CH49 2,Total,1576,1538,38
2011,CH49 3,CH49 3,Total,1520,1492,28
2011,CH49 4,CH49 4,Total,2359,2284,75
2011,CH49 5,CH49 5,Total,744,686,58
2011,CH49 6,CH49 6,Total,1740,1688,52
2011,CH49 7,CH49 7,Total,990,972,18
2011,CH49 8,CH49 8,Total,1351,1304,47
2011,CH49 9,CH49 9,Total,828,811,17
2011,CH5  1,CH5  1,Total,3871,3746,125
2011,CH5  2,CH5  2,Total,3262,3172,90
2011,CH5  3,CH5  3,Total,4177,4016,161
2011,CH5  4,CH5  4,Total,6811,6723,88
2011,CH6  5,CH6  5,Total,5438,5354,84
2011,CH6  6,CH6  6,Total,1670,1612,58
2011,CH60 0,CH60 0,Total,633,608,25
2011,CH60 1,CH60 1,Total,810,788,22
2011,CH60 2,CH60 2,Total,660,641,19
2011,CH60 3,CH60 3,Total,414,404,10
2011,CH60 4,CH60 4,Total,363,355,8
2011,CH60 5,CH60 5,Total,904,865,39
2011,CH60 6,CH60 6,Total,532,517,15
2011,CH60 7,CH60 7,Total,624,590,34
2011,CH60 8,CH60 8,Total,411,391,20
2011,CH60 9,CH60 9,Total,548,534,14
2011,CH61 0,CH61 0,Total,219,211,8
2011,CH61 1,CH61 1,Total,520,503,17
2011,CH61 2,CH61 2,Total,256,251,5
2011,CH61 3,CH61 3,Total,774,760,14
2011,CH61 4,CH61 4,Total,1241,1221,20
2011,CH61 5,CH61 5,Total,1176,1149,27
2011,CH61 6,CH61 6,Total,1094,1066,28
2011,CH61 7,CH61 7,Total,904,870,34
2011,CH61 8,CH61 8,Total,1015,996,19
2011,CH61 9,CH61 9,Total,720,710,10
2011,CH62 0,CH62 0,Total,494,478,16
2011,CH62 1,CH62 1,Total,1575,1471,104
2011,CH62 2,CH62 2,Total,1533,1485,48
2011,CH62 3,CH62 3,Total,503,492,11
2011,CH62 4,CH62 4,Total,914,887,27
2011,CH62 5,CH62 5,Total,1194,1133,61
2011,CH62 6,CH62 6,Total,1656,1611,45
2011,CH62 7,CH62 7,Total,1517,1481,36
2011,CH62 8,CH62 8,Total,2122,2069,53
2011,CH62 9,CH62 9,Total,1575,1538,37
2011,CH63 0,CH63 0,Total,1914,1878,36
2011,CH63 1,CH63 1,Total,149,146,3
2011,CH63 2,CH63 2,Total,2103,2052,51
2011,CH63 3,CH63 3,Total,1816,1783,33
2011,CH63 4,CH63 4,Total,145,135,10
2011,CH63 5,CH63 5,Total,1707,1661,46
2011,CH63 6,CH63 6,Total,216,194,22
2011,CH63 7,CH63 7,Total,1787,1735,52
2011,CH63 8,CH63 8,Total,1316,1276,40
2011,CH63 9,CH63 9,Total,1912,1874,38
2011,CH64 0,CH64 0,Total,1263,1238,25
2011,CH64 1,CH64 1,Total,648,617,31
2011,CH64 2,CH64 2,Total,578,558,20
2011,CH64 3,CH64 3,Total,932,897,35
2011,CH64 4,CH64 4,Total,1286,1227,59
2011,CH64 5,CH64 5,Total,392,369,23
2011,CH64 6,CH64 6,Total,1401,1333,68
2011,CH64 7,CH64 7,Total,128,118,10
2011,CH64 8,CH64 8,Total,66,66,0
2011,CH64 9,CH64 9,Total,2088,1964,124
2011,CH65 0,CH65 0,Total,498,494,4
2011,CH65 2,CH65 2,Total,1410,1324,86
2011,CH65 3,CH65 3,Total,471,450,21
2011,CH65 4,CH65 4,Total,547,477,70
2011,CH65 5,CH65 5,Total,1527,1489,38
2011,CH65 6,CH65 6,Total,1382,1329,53
2011,CH65 7,CH65 7,Total,1628,1523,105
2011,CH65 8,CH65 8,Total,2179,2061,118
2011,CH65 9,CH65 9,Total,2450,2352,98
2011,CH66 1,CH66 1,Total,2878,2755,123
2011,CH66 2,CH66 2,Total,5245,5148,97
2011,CH66 3,CH66 3,Total,2696,2586,110
2011,CH66 4,CH66 4,Total,3671,3571,100
2011,CH66 5,CH66 5,Total,463,443,20
2011,CH66 6,CH66 6,Total,160,154,6
2011,CH66 7,CH66 7,Total,84,76,8
2011,CH7  1,CH7  1,Total,4466,4313,153
2011,CH7  2,CH7  2,Total,4243,4121,122
2011,CH7  3,CH7  3,Total,2657,2579,78
2011,CH7  4,CH7  4,Total,2707,2570,137
2011,CH7  5,CH7  5,Total,2938,2791,147
2011,CH7  6,CH7  6,Total,4903,4779,124
2011,CH8  7,CH8  7,Total,4047,3870,177
2011,CH8  8,CH8  8,Total,2683,2577,106
2011,CH8  9,CH8  9,Total,2456,2282,174
2011,CM0  7,CM0  7,Total,3611,3383,228
2011,CM0  8,CM0  8,Total,3728,3519,209
2011,CM1  1,CM1  1,Total,1760,1680,80
2011,CM1  2,CM1  2,Total,6765,6630,135
2011,CM1  3,CM1  3,Total,3617,3550,67
2011,CM1  4,CM1  4,Total,5579,5452,127
2011,CM1  6,CM1  6,Total,5420,5354,66
2011,CM1  7,CM1  7,Total,3526,3457,69
2011,CM11 1,CM11 1,Total,2823,2742,81
2011,CM11 2,CM11 2,Total,4796,4700,96
2011,CM12 0,CM12 0,Total,5313,5218,95
2011,CM12 9,CM12 9,Total,3313,3225,88
2011,CM13 1,CM13 1,Total,3500,3392,108
2011,CM13 2,CM13 2,Total,4406,4262,144
2011,CM13 3,CM13 3,Total,2552,2449,103
2011,CM14 4,CM14 4,Total,5032,4740,292
2011,CM14 5,CM14 5,Total,4221,3966,255
2011,CM15 0,CM15 0,Total,3563,3435,128
2011,CM15 8,CM15 8,Total,2414,2281,133
2011,CM15 9,CM15 9,Total,3776,3631,145
2011,CM16 4,CM16 4,Total,1747,1691,56
2011,CM16 5,CM16 5,Total,1644,1532,112
2011,CM16 6,CM16 6,Total,3604,3330,274
2011,CM16 7,CM16 7,Total,2911,2800,111
2011,CM17 0,CM17 0,Total,3093,2954,139
2011,CM17 9,CM17 9,Total,6078,5872,206
2011,CM18 6,CM18 6,Total,5580,5497,83
2011,CM18 7,CM18 7,Total,4895,4802,93
2011,CM19 4,CM19 4,Total,4591,4429,162
2011,CM19 5,CM19 5,Total,3543,3421,122
2011,CM2  0,CM2  0,Total,2634,2524,110
2011,CM2  6,CM2  6,Total,6255,6125,130
2011,CM2  7,CM2  7,Total,3783,3692,91
2011,CM2  8,CM2  8,Total,6385,6256,129
2011,CM2  9,CM2  9,Total,6043,5916,127
2011,CM20 1,CM20 1,Total,3082,2811,271
2011,CM20 2,CM20 2,Total,1849,1785,64
2011,CM20 3,CM20 3,Total,4789,4663,126
2011,CM21 0,CM21 0,Total,1751,1712,39
2011,CM21 9,CM21 9,Total,3144,2958,186
2011,CM22 6,CM22 6,Total,2770,2633,137
2011,CM22 7,CM22 7,Total,2522,2398,124
2011,CM23 1,CM23 1,Total,629,603,26
2011,CM23 2,CM23 2,Total,3301,3159,142
2011,CM23 3,CM23 3,Total,4221,4043,178
2011,CM23 4,CM23 4,Total,4997,4950,47
2011,CM23 5,CM23 5,Total,3575,3460,115
2011,CM24 8,CM24 8,Total,2880,2696,184
2011,CM3  1,CM3  1,Total,2276,2197,79
2011,CM3  2,CM3  2,Total,2296,2230,66
2011,CM3  3,CM3  3,Total,2066,2026,40
2011,CM3  4,CM3  4,Total,3782,3701,81
2011,CM3  5,CM3  5,Total,6133,6026,107
2011,CM3  6,CM3  6,Total,3881,3682,199
2011,CM3  7,CM3  7,Total,582,574,8
2011,CM3  8,CM3  8,Total,1231,1204,27
2011,CM4  0,CM4  0,Total,2055,1938,117
2011,CM4  9,CM4  9,Total,2469,2390,79
2011,CM5  0,CM5  0,Total,2355,2183,172
2011,CM5  9,CM5  9,Total,2260,2131,129
2011,CM6  1,CM6  1,Total,5137,4845,292
2011,CM6  2,CM6  2,Total,2613,2476,137
2011,CM6  3,CM6  3,Total,2702,2592,110
2011,CM7  1,CM7  1,Total,4005,3876,129
2011,CM7  2,CM7  2,Total,2443,2374,69
2011,CM7  3,CM7  3,Total,4908,4785,123
2011,CM7  4,CM7  4,Total,1837,1763,74
2011,CM7  5,CM7  5,Total,4029,3932,97
2011,CM7  9,CM7  9,Total,3640,3568,72
2011,CM77 6,CM77 6,Total,1066,1047,19
2011,CM77 7,CM77 7,Total,2676,2636,40
2011,CM77 8,CM77 8,Total,2155,2090,65
2011,CM8  1,CM8  1,Total,6090,5971,119
2011,CM8  2,CM8  2,Total,5224,5105,119
2011,CM8  3,CM8  3,Total,2838,2757,81
2011,CM9  4,CM9  4,Total,3854,3717,137
2011,CM9  5,CM9  5,Total,2132,2015,117
2011,CM9  6,CM9  6,Total,4806,4675,131
2011,CM9  8,CM9  8,Total,4047,3721,326
2011,CO1  1,CO1  1,Total,2465,2351,114
2011,CO1  2,CO1  2,Total,5367,4988,379
2011,CO10 0,CO10 0,Total,5592,5438,154
2011,CO10 1,CO10 1,Total,3703,3595,108
2011,CO10 2,CO10 2,Total,2378,2263,115
2011,CO10 5,CO10 5,Total,979,941,38
2011,CO10 7,CO10 7,Total,2891,2784,107
2011,CO10 8,CO10 8,Total,2544,2423,121
2011,CO10 9,CO10 9,Total,3159,2939,220
2011,CO11 1,CO11 1,Total,2685,2570,115
2011,CO11 2,CO11 2,Total,3147,3029,118
2011,CO12 3,CO12 3,Total,3527,3261,266
2011,CO12 4,CO12 4,Total,5056,4881,175
2011,CO12 5,CO12 5,Total,1666,1594,72
2011,CO13 0,CO13 0,Total,3882,3691,191
2011,CO13 9,CO13 9,Total,2492,1979,513
2011,CO14 8,CO14 8,Total,3733,3288,445
2011,CO15 1,CO15 1,Total,3477,3187,290
2011,CO15 2,CO15 2,Total,3696,3285,411
2011,CO15 3,CO15 3,Total,4077,3700,377
2011,CO15 4,CO15 4,Total,4060,3840,220
2011,CO15 5,CO15 5,Total,3614,3334,280
2011,CO15 6,CO15 6,Total,2914,2724,190
2011,CO16 0,CO16 0,Total,1278,1210,68
2011,CO16 7,CO16 7,Total,2312,2190,122
2011,CO16 8,CO16 8,Total,5304,4803,501
2011,CO16 9,CO16 9,Total,2528,2382,146
2011,CO2  0,CO2  0,Total,1868,1825,43
2011,CO2  7,CO2  7,Total,3600,3445,155
2011,CO2  8,CO2  8,Total,5545,5284,261
2011,CO2  9,CO2  9,Total,3333,3205,128
2011,CO3  0,CO3  0,Total,3369,3281,88
2011,CO3  3,CO3  3,Total,3753,3535,218
2011,CO3  4,CO3  4,Total,2906,2830,76
2011,CO3  8,CO3  8,Total,332,321,11
2011,CO3  9,CO3  9,Total,2002,1934,68
2011,CO4  0,CO4  0,Total,3129,3051,78
2011,CO4  3,CO4  3,Total,6569,6348,221
2011,CO4  5,CO4  5,Total,6007,5785,222
2011,CO4  9,CO4  9,Total,3774,3714,60
2011,CO5  0,CO5  0,Total,4262,4122,140
2011,CO5  7,CO5  7,Total,1993,1907,86
2011,CO5  8,CO5  8,Total,3676,3406,270
2011,CO5  9,CO5  9,Total,2693,2610,83
2011,CO6  1,CO6  1,Total,4180,4031,149
2011,CO6  2,CO6  2,Total,2651,2559,92
2011,CO6  3,CO6  3,Total,2582,2492,90
2011,CO6  4,CO6  4,Total,2541,2424,117
2011,CO6  5,CO6  5,Total,363,342,21
2011,CO7  0,CO7  0,Total,3899,3628,271
2011,CO7  6,CO7  6,Total,2641,2481,160
2011,CO7  7,CO7  7,Total,2297,2214,83
2011,CO7  8,CO7  8,Total,2478,2379,99
2011,CO7  9,CO7  9,Total,3483,3339,144
2011,CO8  5,CO8  5,Total,1035,986,49
2011,CO9  1,CO9  1,Total,4236,4084,152
2011,CO9  2,CO9  2,Total,2711,2628,83
2011,CO9  3,CO9  3,Total,2471,2396,75
2011,CO9  4,CO9  4,Total,1715,1670,45
2011,CR0  0,CR0  0,Total,6685,6586,99
2011,CR0  1,CR0  1,Total,4367,4190,177
2011,CR0  2,CR0  2,Total,8444,8126,318
2011,CR0  3,CR0  3,Total,6828,6706,122
2011,CR0  4,CR0  4,Total,7069,6859,210
2011,CR0  5,CR0  5,Total,4895,4609,286
2011,CR0  6,CR0  6,Total,9704,9415,289
2011,CR0  7,CR0  7,Total,6281,6172,109
2011,CR0  8,CR0  8,Total,4972,4894,78
2011,CR0  9,CR0  9,Total,4513,4453,60
2011,CR2  0,CR2  0,Total,4437,4344,93
2011,CR2  6,CR2  6,Total,4950,4798,152
2011,CR2  7,CR2  7,Total,3780,3668,112
2011,CR2  8,CR2  8,Total,4343,4305,38
2011,CR2  9,CR2  9,Total,2736,2690,46
2011,CR3  0,CR3  0,Total,1957,1902,55
2011,CR3  5,CR3  5,Total,5135,4976,159
2011,CR3  6,CR3  6,Total,4135,3950,185
2011,CR3  7,CR3  7,Total,806,744,62
2011,CR4  1,CR4  1,Total,6428,6241,187
2011,CR4  2,CR4  2,Total,5014,4821,193
2011,CR4  3,CR4  3,Total,7139,6989,150
2011,CR4  4,CR4  4,Total,3812,3723,89
2011,CR5  1,CR5  1,Total,4338,4269,69
2011,CR5  2,CR5  2,Total,3553,3478,75
2011,CR5  3,CR5  3,Total,3449,3377,72
2011,CR6  9,CR6  9,Total,4193,4037,156
2011,CR7  6,CR7  6,Total,3100,3011,89
2011,CR7  7,CR7  7,Total,6525,6385,140
2011,CR7  8,CR7  8,Total,7036,6883,153
2011,CR8  1,CR8  1,Total,1828,1797,31
2011,CR8  2,CR8  2,Total,3554,3437,117
2011,CR8  3,CR8  3,Total,1709,1672,37
2011,CR8  4,CR8  4,Total,2319,2279,40
2011,CR8  5,CR8  5,Total,3295,3217,78
2011,CT1  1,CT1  1,Total,5173,4992,181
2011,CT1  2,CT1  2,Total,2186,1983,203
2011,CT1  3,CT1  3,Total,5165,4946,219
2011,CT10 1,CT10 1,Total,3936,3323,613
2011,CT10 2,CT10 2,Total,4773,4556,217
2011,CT10 3,CT10 3,Total,3254,3021,233
2011,CT11 0,CT11 0,Total,3478,3331,147
2011,CT11 7,CT11 7,Total,3927,3761,166
2011,CT11 8,CT11 8,Total,3276,2888,388
2011,CT11 9,CT11 9,Total,3654,3215,439
2011,CT12 4,CT12 4,Total,1957,1713,244
2011,CT12 5,CT12 5,Total,1350,1144,206
2011,CT12 6,CT12 6,Total,4879,4763,116
2011,CT13 0,CT13 0,Total,2592,2520,72
2011,CT13 9,CT13 9,Total,1633,1445,188
2011,CT14 0,CT14 0,Total,1276,1235,41
2011,CT14 6,CT14 6,Total,3032,2702,330
2011,CT14 7,CT14 7,Total,4714,4324,390
2011,CT14 8,CT14 8,Total,1454,1194,260
2011,CT14 9,CT14 9,Total,6448,6280,168
2011,CT15 4,CT15 4,Total,1543,1496,47
2011,CT15 5,CT15 5,Total,1435,1132,303
2011,CT15 6,CT15 6,Total,1501,1196,305
2011,CT15 7,CT15 7,Total,1557,1534,23
2011,CT16 1,CT16 1,Total,2039,1841,198
2011,CT16 2,CT16 2,Total,4499,4372,127
2011,CT16 3,CT16 3,Total,2388,2342,46
2011,CT17 0,CT17 0,Total,5469,5260,209
2011,CT17 9,CT17 9,Total,4373,4154,219
2011,CT18 7,CT18 7,Total,4518,4249,269
2011,CT18 8,CT18 8,Total,1408,1360,48
2011,CT19 4,CT19 4,Total,3738,3611,127
2011,CT19 5,CT19 5,Total,4404,4265,139
2011,CT19 6,CT19 6,Total,4018,3901,117
2011,CT2  0,CT2  0,Total,2535,2426,109
2011,CT2  7,CT2  7,Total,3556,3487,69
2011,CT2  8,CT2  8,Total,3295,3203,92
2011,CT2  9,CT2  9,Total,1562,1525,37
2011,CT20 1,CT20 1,Total,4130,3845,285
2011,CT20 2,CT20 2,Total,4446,4044,402
2011,CT20 3,CT20 3,Total,3490,3286,204
2011,CT21 4,CT21 4,Total,1925,1853,72
2011,CT21 5,CT21 5,Total,3197,3028,169
2011,CT21 6,CT21 6,Total,3221,3008,213
2011,CT3  1,CT3  1,Total,2603,2441,162
2011,CT3  2,CT3  2,Total,1392,1332,60
2011,CT3  3,CT3  3,Total,1798,1757,41
2011,CT3  4,CT3  4,Total,1471,1402,69
2011,CT4  5,CT4  5,Total,1812,1679,133
2011,CT4  6,CT4  6,Total,2208,2107,101
2011,CT4  7,CT4  7,Total,2290,2209,81
2011,CT4  8,CT4  8,Total,842,795,47
2011,CT5  1,CT5  1,Total,3884,3440,444
2011,CT5  2,CT5  2,Total,4035,3776,259
2011,CT5  3,CT5  3,Total,2834,2753,81
2011,CT5  4,CT5  4,Total,4816,4553,263
2011,CT6  5,CT6  5,Total,3824,3464,360
2011,CT6  6,CT6  6,Total,4347,4131,216
2011,CT6  7,CT6  7,Total,5177,5046,131
2011,CT6  8,CT6  8,Total,4014,3794,220
2011,CT7  0,CT7  0,Total,2248,1916,332
2011,CT7  9,CT7  9,Total,4006,3693,313
2011,CT8  8,CT8  8,Total,3759,3382,377
2011,CT9  1,CT9  1,Total,3824,3194,630
2011,CT9  2,CT9  2,Total,5205,4561,644
2011,CT9  3,CT9  3,Total,5033,4844,189
2011,CT9  4,CT9  4,Total,1906,1701,205
2011,CT9  5,CT9  5,Total,4811,4507,304
2011,CV1  1,CV1  1,Total,217,154,63
2011,CV1  2,CV1  2,Total,2819,2635,184
2011,CV1  3,CV1  3,Total,2331,2178,153
2011,CV1  4,CV1  4,Total,3824,3571,253
2011,CV1  5,CV1  5,Total,3490,3354,136
2011,CV10 0,CV10 0,Total,5642,5440,202
2011,CV10 7,CV10 7,Total,4733,4587,146
2011,CV10 8,CV10 8,Total,5220,5070,150
2011,CV10 9,CV10 9,Total,5828,5639,189
2011,CV11 4,CV11 4,Total,5347,5201,146
2011,CV11 5,CV11 5,Total,5140,4932,208
2011,CV11 6,CV11 6,Total,6490,6349,141
2011,CV12 0,CV12 0,Total,3877,3778,99
2011,CV12 8,CV12 8,Total,4780,4653,127
2011,CV12 9,CV12 9,Total,5388,5235,153
2011,CV13 0,CV13 0,Total,2841,2743,98
2011,CV13 6,CV13 6,Total,1799,1753,46
2011,CV2  1,CV2  1,Total,5507,5232,275
2011,CV2  2,CV2  2,Total,5359,5219,140
2011,CV2  3,CV2  3,Total,5501,5315,186
2011,CV2  4,CV2  4,Total,5967,5642,325
2011,CV2  5,CV2  5,Total,5066,4928,138
2011,CV21 1,CV21 1,Total,4193,4097,96
2011,CV21 2,CV21 2,Total,3889,3718,171
2011,CV21 3,CV21 3,Total,4679,4463,216
2011,CV21 4,CV21 4,Total,3386,3303,83
2011,CV22 5,CV22 5,Total,3708,3634,74
2011,CV22 6,CV22 6,Total,4735,4603,132
2011,CV22 7,CV22 7,Total,6361,6193,168
2011,CV23 0,CV23 0,Total,3987,3852,135
2011,CV23 8,CV23 8,Total,1939,1883,56
2011,CV23 9,CV23 9,Total,2893,2799,94
2011,CV3  1,CV3  1,Total,3708,3557,151
2011,CV3  2,CV3  2,Total,6838,6618,220
2011,CV3  3,CV3  3,Total,3847,3680,167
2011,CV3  4,CV3  4,Total,2134,2066,68
2011,CV3  5,CV3  5,Total,5863,5726,137
2011,CV3  6,CV3  6,Total,5085,4955,130
2011,CV31 1,CV31 1,Total,5137,4976,161
2011,CV31 2,CV31 2,Total,4951,4830,121
2011,CV31 3,CV31 3,Total,3088,2983,105
2011,CV32 4,CV32 4,Total,1611,1516,95
2011,CV32 5,CV32 5,Total,4252,4031,221
2011,CV32 6,CV32 6,Total,3311,3194,117
2011,CV32 7,CV32 7,Total,5959,5837,122
2011,CV33 9,CV33 9,Total,2646,2570,76
2011,CV34 4,CV34 4,Total,2866,2704,162
2011,CV34 5,CV34 5,Total,6448,6209,239
2011,CV34 6,CV34 6,Total,4912,4797,115
2011,CV35 0,CV35 0,Total,2544,2432,112
2011,CV35 7,CV35 7,Total,2238,2177,61
2011,CV35 8,CV35 8,Total,2470,2401,69
2011,CV35 9,CV35 9,Total,3375,3271,104
2011,CV36 4,CV36 4,Total,3103,2966,137
2011,CV36 5,CV36 5,Total,1374,1256,118
2011,CV37 0,CV37 0,Total,2952,2828,124
2011,CV37 6,CV37 6,Total,3961,3506,455
2011,CV37 7,CV37 7,Total,3822,3632,190
2011,CV37 8,CV37 8,Total,3118,2906,212
2011,CV37 9,CV37 9,Total,5353,5118,235
2011,CV4  7,CV4  7,Total,1714,1668,46
2011,CV4  8,CV4  8,Total,3125,3016,109
2011,CV4  9,CV4  9,Total,7572,7299,273
2011,CV47 0,CV47 0,Total,976,956,20
2011,CV47 1,CV47 1,Total,1857,1822,35
2011,CV47 2,CV47 2,Total,2141,2047,94
2011,CV47 7,CV47 7,Total,336,317,19
2011,CV47 8,CV47 8,Total,1013,981,32
2011,CV47 9,CV47 9,Total,861,827,34
2011,CV5  6,CV5  6,Total,5642,5358,284
2011,CV5  7,CV5  7,Total,5271,5116,155
2011,CV5  8,CV5  8,Total,5471,5284,187
2011,CV5  9,CV5  9,Total,4447,4278,169
2011,CV6  1,CV6  1,Total,5865,5676,189
2011,CV6  2,CV6  2,Total,5135,4975,160
2011,CV6  3,CV6  3,Total,4308,4188,120
2011,CV6  4,CV6  4,Total,5314,5103,211
2011,CV6  5,CV6  5,Total,4872,4666,206
2011,CV6  6,CV6  6,Total,4536,4391,145
2011,CV6  7,CV6  7,Total,5076,4897,179
2011,CV7  7,CV7  7,Total,4553,4407,146
2011,CV7  8,CV7  8,Total,3677,3455,222
2011,CV7  9,CV7  9,Total,3664,3572,92
2011,CV8  1,CV8  1,Total,4999,4849,150
2011,CV8  2,CV8  2,Total,6037,5886,151
2011,CV8  3,CV8  3,Total,2937,2845,92
2011,CV9  1,CV9  1,Total,2731,2597,134
2011,CV9  2,CV9  2,Total,3908,3750,158
2011,CV9  3,CV9  3,Total,2769,2678,91
2011,CW1  2,CW1  2,Total,855,786,69
2011,CW1  3,CW1  3,Total,7667,7345,322
2011,CW1  4,CW1  4,Total,4705,4556,149
2011,CW1  5,CW1  5,Total,4343,4219,124
2011,CW1  6,CW1  6,Total,533,516,17
2011,CW10 0,CW10 0,Total,3186,3101,85
2011,CW10 9,CW10 9,Total,3078,2890,188
2011,CW11 1,CW11 1,Total,3357,3195,162
2011,CW11 2,CW11 2,Total,821,798,23
2011,CW11 3,CW11 3,Total,3019,2931,88
2011,CW11 4,CW11 4,Total,2846,2766,80
2011,CW12 1,CW12 1,Total,1941,1846,95
2011,CW12 2,CW12 2,Total,2180,2103,77
2011,CW12 3,CW12 3,Total,4307,4177,130
2011,CW12 4,CW12 4,Total,4823,4580,243
2011,CW2  5,CW2  5,Total,3595,3454,141
2011,CW2  6,CW2  6,Total,4521,4314,207
2011,CW2  7,CW2  7,Total,4167,3928,239
2011,CW2  8,CW2  8,Total,5732,5607,125
2011,CW3  0,CW3  0,Total,1249,1178,71
2011,CW3  9,CW3  9,Total,2893,2748,145
2011,CW4  7,CW4  7,Total,2603,2503,100
2011,CW4  8,CW4  8,Total,1529,1472,57
2011,CW5  5,CW5  5,Total,4130,3860,270
2011,CW5  6,CW5  6,Total,3444,3297,147
2011,CW5  7,CW5  7,Total,3996,3861,135
2011,CW5  8,CW5  8,Total,1879,1797,82
2011,CW6  0,CW6  0,Total,3028,2918,110
2011,CW6  9,CW6  9,Total,2219,2107,112
2011,CW7  1,CW7  1,Total,3874,3757,117
2011,CW7  2,CW7  2,Total,4666,4521,145
2011,CW7  3,CW7  3,Total,3922,3796,126
2011,CW7  4,CW7  4,Total,841,792,49
2011,CW8  1,CW8  1,Total,3931,3772,159
2011,CW8  2,CW8  2,Total,3985,3786,199
2011,CW8  3,CW8  3,Total,3160,3065,95
2011,CW8  4,CW8  4,Total,4583,4437,146
2011,CW9  5,CW9  5,Total,1605,1527,78
2011,CW9  6,CW9  6,Total,2476,2410,66
2011,CW9  7,CW9  7,Total,4679,4545,134
2011,CW9  8,CW9  8,Total,5642,5516,126
2011,DA1  1,DA1  1,Total,4130,3986,144
2011,DA1  2,DA1  2,Total,4966,4833,133
2011,DA1  3,DA1  3,Total,4672,4577,95
2011,DA1  4,DA1  4,Total,3735,3657,78
2011,DA1  5,DA1  5,Total,4876,4714,162
2011,DA10 0,DA10 0,Total,2904,2840,64
2011,DA11 0,DA11 0,Total,3758,3595,163
2011,DA11 7,DA11 7,Total,3657,3577,80
2011,DA11 8,DA11 8,Total,4307,4237,70
2011,DA11 9,DA11 9,Total,3962,3784,178
2011,DA12 1,DA12 1,Total,2948,2790,158
2011,DA12 2,DA12 2,Total,3792,3629,163
2011,DA12 3,DA12 3,Total,1014,981,33
2011,DA12 4,DA12 4,Total,5716,5632,84
2011,DA12 5,DA12 5,Total,5966,5799,167
2011,DA13 0,DA13 0,Total,3685,3534,151
2011,DA13 9,DA13 9,Total,2227,2184,43
2011,DA14 4,DA14 4,Total,4307,4181,126
2011,DA14 5,DA14 5,Total,1851,1802,49
2011,DA14 6,DA14 6,Total,3570,3427,143
2011,DA15 7,DA15 7,Total,2179,2129,50
2011,DA15 8,DA15 8,Total,5907,5780,127
2011,DA15 9,DA15 9,Total,3563,3494,69
2011,DA16 1,DA16 1,Total,4805,4688,117
2011,DA16 2,DA16 2,Total,5532,5423,109
2011,DA16 3,DA16 3,Total,3661,3558,103
2011,DA17 5,DA17 5,Total,4479,4333,146
2011,DA17 6,DA17 6,Total,2676,2613,63
2011,DA18 4,DA18 4,Total,2015,1962,53
2011,DA2  6,DA2  6,Total,3970,3892,78
2011,DA2  7,DA2  7,Total,4651,4565,86
2011,DA2  8,DA2  8,Total,662,650,12
2011,DA3  7,DA3  7,Total,3299,3244,55
2011,DA3  8,DA3  8,Total,3610,3544,66
2011,DA4  0,DA4  0,Total,1395,1351,44
2011,DA4  9,DA4  9,Total,2616,2557,59
2011,DA5  1,DA5  1,Total,2934,2861,73
2011,DA5  2,DA5  2,Total,2069,2036,33
2011,DA5  3,DA5  3,Total,3453,3367,86
2011,DA6  7,DA6  7,Total,1728,1688,40
2011,DA6  8,DA6  8,Total,2365,2305,60
2011,DA7  4,DA7  4,Total,5115,5003,112
2011,DA7  5,DA7  5,Total,4804,4729,75
2011,DA7  6,DA7  6,Total,4588,4514,74
2011,DA8  1,DA8  1,Total,5490,5312,178
2011,DA8  2,DA8  2,Total,4436,4346,90
2011,DA8  3,DA8  3,Total,4134,4039,95
2011,DA9  9,DA9  9,Total,6107,5788,319
2011,DE1  1,DE1  1,Total,2659,2445,214
2011,DE1  2,DE1  2,Total,1478,1371,107
2011,DE1  3,DE1  3,Total,2924,2786,138
2011,DE11 0,DE11 0,Total,6571,6356,215
2011,DE11 7,DE11 7,Total,4194,4028,166
2011,DE11 8,DE11 8,Total,2696,2585,111
2011,DE11 9,DE11 9,Total,5604,5386,218
2011,DE12 6,DE12 6,Total,3273,3173,100
2011,DE12 7,DE12 7,Total,3881,3759,122
2011,DE12 8,DE12 8,Total,1610,1552,58
2011,DE13 0,DE13 0,Total,8102,7858,244
2011,DE13 7,DE13 7,Total,1778,1699,79
2011,DE13 8,DE13 8,Total,3482,3365,117
2011,DE13 9,DE13 9,Total,4323,4164,159
2011,DE14 1,DE14 1,Total,1340,1287,53
2011,DE14 2,DE14 2,Total,5435,5148,287
2011,DE14 3,DE14 3,Total,5864,5596,268
2011,DE15 0,DE15 0,Total,4094,3925,169
2011,DE15 9,DE15 9,Total,6492,6315,177
2011,DE21 2,DE21 2,Total,4448,4336,112
2011,DE21 4,DE21 4,Total,5578,5417,161
2011,DE21 5,DE21 5,Total,1605,1550,55
2011,DE21 6,DE21 6,Total,7479,7210,269
2011,DE21 7,DE21 7,Total,5622,5405,217
2011,DE22 1,DE22 1,Total,3045,2879,166
2011,DE22 2,DE22 2,Total,6120,5956,164
2011,DE22 3,DE22 3,Total,8266,7804,462
2011,DE22 4,DE22 4,Total,3417,3343,74
2011,DE22 5,DE22 5,Total,382,371,11
2011,DE23 1,DE23 1,Total,3457,3364,93
2011,DE23 2,DE23 2,Total,1301,1268,33
2011,DE23 3,DE23 3,Total,2124,2091,33
2011,DE23 4,DE23 4,Total,1114,1088,26
2011,DE23 6,DE23 6,Total,6985,6641,344
2011,DE23 8,DE23 8,Total,7813,7269,544
2011,DE24 0,DE24 0,Total,7035,6795,240
2011,DE24 1,DE24 1,Total,580,486,94
2011,DE24 3,DE24 3,Total,2462,2412,50
2011,DE24 5,DE24 5,Total,480,474,6
2011,DE24 8,DE24 8,Total,7209,6808,401
2011,DE24 9,DE24 9,Total,5864,5655,209
2011,DE3  0,DE3  0,Total,3546,3454,92
2011,DE3  9,DE3  9,Total,3822,3702,120
2011,DE4  2,DE4  2,Total,4323,3958,365
2011,DE4  3,DE4  3,Total,5837,5439,398
2011,DE4  4,DE4  4,Total,3267,2999,268
2011,DE4  5,DE4  5,Total,2492,2314,178
2011,DE45 1,DE45 1,Total,4375,3908,467
2011,DE5  3,DE5  3,Total,6032,5805,227
2011,DE5  8,DE5  8,Total,1630,1588,42
2011,DE5  9,DE5  9,Total,2150,2072,78
2011,DE55 1,DE55 1,Total,3066,2982,84
2011,DE55 2,DE55 2,Total,3244,3096,148
2011,DE55 3,DE55 3,Total,1641,1591,50
2011,DE55 4,DE55 4,Total,3878,3716,162
2011,DE55 5,DE55 5,Total,3623,3489,134
2011,DE55 6,DE55 6,Total,3255,3170,85
2011,DE55 7,DE55 7,Total,4399,4205,194
2011,DE56 0,DE56 0,Total,5493,5302,191
2011,DE56 1,DE56 1,Total,6253,5885,368
2011,DE56 2,DE56 2,Total,4154,3949,205
2011,DE56 4,DE56 4,Total,2289,2158,131
2011,DE6  1,DE6  1,Total,5056,4741,315
2011,DE6  2,DE6  2,Total,2450,2225,225
2011,DE6  3,DE6  3,Total,1590,1492,98
2011,DE6  4,DE6  4,Total,468,449,19
2011,DE6  5,DE6  5,Total,1677,1613,64
2011,DE65 5,DE65 5,Total,4895,4754,141
2011,DE65 6,DE65 6,Total,4668,4541,127
2011,DE7  4,DE7  4,Total,5536,5392,144
2011,DE7  5,DE7  5,Total,4576,4353,223
2011,DE7  6,DE7  6,Total,4627,4454,173
2011,DE7  8,DE7  8,Total,6335,6005,330
2011,DE7  9,DE7  9,Total,1241,1226,15
2011,DE72 2,DE72 2,Total,1833,1780,53
2011,DE72 3,DE72 3,Total,7278,7049,229
2011,DE73 5,DE73 5,Total,1794,1746,48
2011,DE73 6,DE73 6,Total,2740,2672,68
2011,DE73 7,DE73 7,Total,832,792,40
2011,DE73 8,DE73 8,Total,2733,2593,140
2011,DE74 2,DE74 2,Total,5110,4919,191
2011,DE75 7,DE75 7,Total,8094,7791,303
2011,DH1  1,DH1  1,Total,4206,4065,141
2011,DH1  2,DH1  2,Total,3867,3729,138
2011,DH1  3,DH1  3,Total,1712,1596,116
2011,DH1  4,DH1  4,Total,2835,2710,125
2011,DH1  5,DH1  5,Total,6150,5975,175
2011,DH2  1,DH2  1,Total,4755,4665,90
2011,DH2  2,DH2  2,Total,4653,4552,101
2011,DH2  3,DH2  3,Total,4351,4209,142
2011,DH3  1,DH3  1,Total,3311,3195,116
2011,DH3  2,DH3  2,Total,2439,2395,44
2011,DH3  3,DH3  3,Total,3349,3180,169
2011,DH3  4,DH3  4,Total,2815,2759,56
2011,DH4  4,DH4  4,Total,3639,3521,118
2011,DH4  5,DH4  5,Total,3105,3054,51
2011,DH4  6,DH4  6,Total,3987,3834,153
2011,DH4  7,DH4  7,Total,4023,3864,159
2011,DH5  0,DH5  0,Total,3304,3156,148
2011,DH5  8,DH5  8,Total,2603,2518,85
2011,DH5  9,DH5  9,Total,3118,2993,125
2011,DH6  1,DH6  1,Total,3161,3042,119
2011,DH6  2,DH6  2,Total,4150,3990,160
2011,DH6  3,DH6  3,Total,2582,2476,106
2011,DH6  4,DH6  4,Total,3160,3080,80
2011,DH6  5,DH6  5,Total,2266,2140,126
2011,DH7  0,DH7  0,Total,2697,2611,86
2011,DH7  6,DH7  6,Total,3879,3750,129
2011,DH7  7,DH7  7,Total,3689,3484,205
2011,DH7  8,DH7  8,Total,4706,4548,158
2011,DH7  9,DH7  9,Total,4484,4262,222
2011,DH8  0,DH8  0,Total,3122,2994,128
2011,DH8  5,DH8  5,Total,3003,2839,164
2011,DH8  6,DH8  6,Total,3184,3057,127
2011,DH8  7,DH8  7,Total,4149,3957,192
2011,DH8  8,DH8  8,Total,3151,2988,163
2011,DH8  9,DH8  9,Total,1321,1220,101
2011,DH9  0,DH9  0,Total,2276,2172,104
2011,DH9  6,DH9  6,Total,4697,4530,167
2011,DH9  7,DH9  7,Total,4022,3704,318
2011,DH9  8,DH9  8,Total,3163,3028,135
2011,DH9  9,DH9  9,Total,3122,3031,91
2011,DL1  1,DL1  1,Total,2489,2397,92
2011,DL1  2,DL1  2,Total,5418,5243,175
2011,DL1  3,DL1  3,Total,3834,3720,114
2011,DL1  4,DL1  4,Total,6447,6203,244
2011,DL1  5,DL1  5,Total,3084,2860,224
2011,DL10 4,DL10 4,Total,2592,2444,148
2011,DL10 5,DL10 5,Total,1583,1503,80
2011,DL10 6,DL10 6,Total,1232,1165,67
2011,DL10 7,DL10 7,Total,2900,2733,167
2011,DL11 6,DL11 6,Total,1378,925,453
2011,DL11 7,DL11 7,Total,1588,1424,164
2011,DL12 0,DL12 0,Total,1356,1182,174
2011,DL12 8,DL12 8,Total,3226,3056,170
2011,DL12 9,DL12 9,Total,1277,1153,124
2011,DL13 1,DL13 1,Total,848,705,143
2011,DL13 2,DL13 2,Total,1581,1434,147
2011,DL13 3,DL13 3,Total,1507,1397,110
2011,DL13 4,DL13 4,Total,1506,1364,142
2011,DL13 5,DL13 5,Total,1666,1545,121
2011,DL14 0,DL14 0,Total,2840,2704,136
2011,DL14 6,DL14 6,Total,5331,5114,217
2011,DL14 7,DL14 7,Total,2402,2259,143
2011,DL14 8,DL14 8,Total,3269,3029,240
2011,DL14 9,DL14 9,Total,3678,3474,204
2011,DL15 0,DL15 0,Total,3986,3831,155
2011,DL15 8,DL15 8,Total,2477,2364,113
2011,DL15 9,DL15 9,Total,4105,3877,228
2011,DL16 6,DL16 6,Total,5196,5065,131
2011,DL16 7,DL16 7,Total,3949,3806,143
2011,DL17 0,DL17 0,Total,2407,2222,185
2011,DL17 8,DL17 8,Total,4355,4163,192
2011,DL17 9,DL17 9,Total,1865,1757,108
2011,DL2  1,DL2  1,Total,2516,2434,82
2011,DL2  2,DL2  2,Total,3203,3041,162
2011,DL2  3,DL2  3,Total,1888,1778,110
2011,DL3  0,DL3  0,Total,6787,6553,234
2011,DL3  6,DL3  6,Total,4588,4234,354
2011,DL3  7,DL3  7,Total,2143,1982,161
2011,DL3  8,DL3  8,Total,3386,3291,95
2011,DL3  9,DL3  9,Total,4289,4153,136
2011,DL4  1,DL4  1,Total,2430,2321,109
2011,DL4  2,DL4  2,Total,2413,2308,105
2011,DL5  4,DL5  4,Total,4143,4033,110
2011,DL5  5,DL5  5,Total,2925,2869,56
2011,DL5  6,DL5  6,Total,1757,1707,50
2011,DL5  7,DL5  7,Total,4085,3991,94
2011,DL6  1,DL6  1,Total,3915,3819,96
2011,DL6  2,DL6  2,Total,1856,1781,75
2011,DL6  3,DL6  3,Total,1298,1200,98
2011,DL7  0,DL7  0,Total,1403,1351,52
2011,DL7  8,DL7  8,Total,3612,3463,149
2011,DL7  9,DL7  9,Total,1870,1771,99
2011,DL8  1,DL8  1,Total,2059,1946,113
2011,DL8  2,DL8  2,Total,2028,1930,98
2011,DL8  3,DL8  3,Total,1869,1361,508
2011,DL8  4,DL8  4,Total,1940,1440,500
2011,DL8  5,DL8  5,Total,1864,1682,182
2011,DL9  3,DL9  3,Total,1603,1507,96
2011,DL9  4,DL9  4,Total,3040,2865,175
2011,DN1  1,DN1  1,Total,156,139,17
2011,DN1  2,DN1  2,Total,3060,2814,246
2011,DN1  3,DN1  3,Total,1223,1155,68
2011,DN10 4,DN10 4,Total,2401,2247,154
2011,DN10 5,DN10 5,Total,695,661,34
2011,DN10 6,DN10 6,Total,2377,2282,95
2011,DN11 0,DN11 0,Total,5686,5537,149
2011,DN11 8,DN11 8,Total,3627,3469,158
2011,DN11 9,DN11 9,Total,3079,2981,98
2011,DN12 1,DN12 1,Total,3394,3253,141
2011,DN12 2,DN12 2,Total,2475,2412,63
2011,DN12 3,DN12 3,Total,2578,2476,102
2011,DN12 4,DN12 4,Total,2005,1962,43
2011,DN14 0,DN14 0,Total,3064,2949,115
2011,DN14 5,DN14 5,Total,3625,3430,195
2011,DN14 6,DN14 6,Total,5631,5444,187
2011,DN14 7,DN14 7,Total,3182,3036,146
2011,DN14 8,DN14 8,Total,2109,2007,102
2011,DN14 9,DN14 9,Total,2629,2535,94
2011,DN15 0,DN15 0,Total,449,427,22
2011,DN15 6,DN15 6,Total,2433,2259,174
2011,DN15 7,DN15 7,Total,3585,3359,226
2011,DN15 8,DN15 8,Total,5071,4939,132
2011,DN15 9,DN15 9,Total,4233,4062,171
2011,DN16 1,DN16 1,Total,3969,3839,130
2011,DN16 2,DN16 2,Total,4020,3882,138
2011,DN16 3,DN16 3,Total,6055,5858,197
2011,DN17 1,DN17 1,Total,5229,5069,160
2011,DN17 2,DN17 2,Total,4904,4780,124
2011,DN17 3,DN17 3,Total,3260,3148,112
2011,DN17 4,DN17 4,Total,2794,2679,115
2011,DN18 5,DN18 5,Total,4107,3860,247
2011,DN18 6,DN18 6,Total,1315,1257,58
2011,DN19 7,DN19 7,Total,2756,2636,120
2011,DN2  4,DN2  4,Total,3315,3186,129
2011,DN2  5,DN2  5,Total,3653,3501,152
2011,DN2  6,DN2  6,Total,3479,3386,93
2011,DN20 0,DN20 0,Total,2982,2885,97
2011,DN20 8,DN20 8,Total,3141,2957,184
2011,DN20 9,DN20 9,Total,2422,2350,72
2011,DN21 1,DN21 1,Total,5423,5071,352
2011,DN21 2,DN21 2,Total,3471,3145,326
2011,DN21 3,DN21 3,Total,3236,3090,146
2011,DN21 4,DN21 4,Total,2234,2124,110
2011,DN21 5,DN21 5,Total,2643,2592,51
2011,DN22 0,DN22 0,Total,1934,1821,113
2011,DN22 6,DN22 6,Total,3519,3319,200
2011,DN22 7,DN22 7,Total,6915,6641,274
2011,DN22 8,DN22 8,Total,2116,2028,88
2011,DN22 9,DN22 9,Total,1387,1330,57
2011,DN3  1,DN3  1,Total,3664,3590,74
2011,DN3  2,DN3  2,Total,5018,4898,120
2011,DN3  3,DN3  3,Total,4460,4337,123
2011,DN31 1,DN31 1,Total,1008,962,46
2011,DN31 2,DN31 2,Total,3682,3448,234
2011,DN31 3,DN31 3,Total,177,147,30
2011,DN32 0,DN32 0,Total,2922,2765,157
2011,DN32 7,DN32 7,Total,3746,3538,208
2011,DN32 8,DN32 8,Total,3717,3589,128
2011,DN32 9,DN32 9,Total,3765,3545,220
2011,DN33 1,DN33 1,Total,2948,2850,98
2011,DN33 2,DN33 2,Total,2211,2147,64
2011,DN33 3,DN33 3,Total,3255,3149,106
2011,DN34 4,DN34 4,Total,3839,3684,155
2011,DN34 5,DN34 5,Total,4730,4596,134
2011,DN35 0,DN35 0,Total,3884,3805,79
2011,DN35 7,DN35 7,Total,5207,4968,239
2011,DN35 8,DN35 8,Total,4029,3822,207
2011,DN35 9,DN35 9,Total,2881,2826,55
2011,DN36 4,DN36 4,Total,4997,4709,288
2011,DN36 5,DN36 5,Total,3639,3523,116
2011,DN37 0,DN37 0,Total,3493,3388,105
2011,DN37 7,DN37 7,Total,1501,1467,34
2011,DN37 8,DN37 8,Total,177,168,9
2011,DN37 9,DN37 9,Total,4263,4192,71
2011,DN38 6,DN38 6,Total,1301,1250,51
2011,DN39 6,DN39 6,Total,1276,1229,47
2011,DN4  0,DN4  0,Total,4786,4552,234
2011,DN4  5,DN4  5,Total,2350,2221,129
2011,DN4  6,DN4  6,Total,5122,4991,131
2011,DN4  7,DN4  7,Total,3383,3299,84
2011,DN4  8,DN4  8,Total,3382,3183,199
2011,DN4  9,DN4  9,Total,4581,4440,141
2011,DN40 1,DN40 1,Total,2400,2333,67
2011,DN40 2,DN40 2,Total,1854,1806,48
2011,DN40 3,DN40 3,Total,1208,1165,43
2011,DN41 7,DN41 7,Total,1178,1149,29
2011,DN41 8,DN41 8,Total,1571,1474,97
2011,DN5  0,DN5  0,Total,4373,4181,192
2011,DN5  7,DN5  7,Total,3762,3666,96
2011,DN5  8,DN5  8,Total,4668,4556,112
2011,DN5  9,DN5  9,Total,4805,4654,151
2011,DN6  0,DN6  0,Total,2673,2550,123
2011,DN6  7,DN6  7,Total,4374,4223,151
2011,DN6  8,DN6  8,Total,3807,3706,101
2011,DN6  9,DN6  9,Total,2374,2289,85
2011,DN7  4,DN7  4,Total,3437,3346,91
2011,DN7  5,DN7  5,Total,3101,2994,107
2011,DN7  6,DN7  6,Total,3090,2985,105
2011,DN8  4,DN8  4,Total,4143,4016,127
2011,DN8  5,DN8  5,Total,3359,3260,99
2011,DN9  1,DN9  1,Total,3826,3621,205
2011,DN9  2,DN9  2,Total,2169,2100,69
2011,DN9  3,DN9  3,Total,2623,2556,67
2011,DT1  1,DT1  1,Total,3163,2977,186
2011,DT1  2,DT1  2,Total,4557,4453,104
2011,DT1  3,DT1  3,Total,1281,1019,262
2011,DT10 1,DT10 1,Total,2886,2720,166
2011,DT10 2,DT10 2,Total,2609,2459,150
2011,DT11 0,DT11 0,Total,2978,2756,222
2011,DT11 7,DT11 7,Total,4717,4560,157
2011,DT11 8,DT11 8,Total,2971,2800,171
2011,DT11 9,DT11 9,Total,2105,2007,98
2011,DT2  0,DT2  0,Total,1780,1591,189
2011,DT2  7,DT2  7,Total,2717,2465,252
2011,DT2  8,DT2  8,Total,3680,3409,271
2011,DT2  9,DT2  9,Total,3609,3281,328
2011,DT3  4,DT3  4,Total,2616,2455,161
2011,DT3  5,DT3  5,Total,4077,3890,187
2011,DT3  6,DT3  6,Total,4339,3767,572
2011,DT4  0,DT4  0,Total,5760,5511,249
2011,DT4  7,DT4  7,Total,4172,3672,500
2011,DT4  8,DT4  8,Total,2811,2314,497
2011,DT4  9,DT4  9,Total,5442,5258,184
2011,DT5  1,DT5  1,Total,2813,2491,322
2011,DT5  2,DT5  2,Total,2797,2684,113
2011,DT6  3,DT6  3,Total,3378,3038,340
2011,DT6  4,DT6  4,Total,3304,2798,506
2011,DT6  5,DT6  5,Total,2918,2625,293
2011,DT6  6,DT6  6,Total,2187,1669,518
2011,DT7  3,DT7  3,Total,3457,2643,814
2011,DT8  3,DT8  3,Total,3107,2776,331
2011,DT9  3,DT9  3,Total,1719,1586,133
2011,DT9  4,DT9  4,Total,2642,2480,162
2011,DT9  5,DT9  5,Total,2319,2174,145
2011,DT9  6,DT9  6,Total,3039,2891,148
2011,DY1  1,DY1  1,Total,399,389,10
2011,DY1  2,DY1  2,Total,6120,5912,208
2011,DY1  3,DY1  3,Total,4425,4300,125
2011,DY1  4,DY1  4,Total,2315,2231,84
2011,DY10 1,DY10 1,Total,3336,3229,107
2011,DY10 2,DY10 2,Total,4922,4769,153
2011,DY10 3,DY10 3,Total,4711,4595,116
2011,DY10 4,DY10 4,Total,3141,3068,73
2011,DY11 5,DY11 5,Total,4314,4228,86
2011,DY11 6,DY11 6,Total,5778,5570,208
2011,DY11 7,DY11 7,Total,3258,3152,106
2011,DY12 1,DY12 1,Total,2495,2262,233
2011,DY12 2,DY12 2,Total,3158,2768,390
2011,DY12 3,DY12 3,Total,634,596,38
2011,DY13 0,DY13 0,Total,3297,3015,282
2011,DY13 8,DY13 8,Total,4058,3912,146
2011,DY13 9,DY13 9,Total,3092,2866,226
2011,DY14 0,DY14 0,Total,781,729,52
2011,DY14 8,DY14 8,Total,1604,1531,73
2011,DY14 9,DY14 9,Total,1273,1210,63
2011,DY2  0,DY2  0,Total,4516,4356,160
2011,DY2  7,DY2  7,Total,3029,2915,114
2011,DY2  8,DY2  8,Total,2815,2661,154
2011,DY2  9,DY2  9,Total,3771,3638,133
2011,DY3  1,DY3  1,Total,4108,3960,148
2011,DY3  2,DY3  2,Total,5163,5010,153
2011,DY3  3,DY3  3,Total,4814,4713,101
2011,DY3  4,DY3  4,Total,770,739,31
2011,DY4  0,DY4  0,Total,5742,5476,266
2011,DY4  7,DY4  7,Total,4169,4004,165
2011,DY4  8,DY4  8,Total,4719,4485,234
2011,DY4  9,DY4  9,Total,3412,3167,245
2011,DY5  1,DY5  1,Total,2748,2642,106
2011,DY5  2,DY5  2,Total,5937,5779,158
2011,DY5  3,DY5  3,Total,5391,5215,176
2011,DY5  4,DY5  4,Total,3649,3545,104
2011,DY6  0,DY6  0,Total,1722,1695,27
2011,DY6  7,DY6  7,Total,1755,1729,26
2011,DY6  8,DY6  8,Total,4557,4462,95
2011,DY6  9,DY6  9,Total,3650,3581,69
2011,DY7  5,DY7  5,Total,904,866,38
2011,DY7  6,DY7  6,Total,2726,2640,86
2011,DY8  1,DY8  1,Total,2633,2493,140
2011,DY8  2,DY8  2,Total,2571,2499,72
2011,DY8  3,DY8  3,Total,5580,5427,153
2011,DY8  4,DY8  4,Total,6064,5864,200
2011,DY8  5,DY8  5,Total,5567,5440,127
2011,DY9  0,DY9  0,Total,4582,4448,134
2011,DY9  7,DY9  7,Total,2291,2202,89
2011,DY9  8,DY9  8,Total,2367,2211,156
2011,DY9  9,DY9  9,Total,3452,3343,109
2011,E1   0,E1   0,Total,3962,3862,100
2011,E1   1,E1   1,Total,2567,2448,119
2011,E1   2,E1   2,Total,2895,2819,76
2011,E1   3,E1   3,Total,2704,2638,66
2011,E1   4,E1   4,Total,5070,4971,99
2011,E1   5,E1   5,Total,4085,3960,125
2011,E1   6,E1   6,Total,2133,1958,175
2011,E1   7,E1   7,Total,1302,1150,152
2011,E1   8,E1   8,Total,2203,2014,189
2011,E10  5,E10  5,Total,5460,5360,100
2011,E10  6,E10  6,Total,5755,5634,121
2011,E10  7,E10  7,Total,4422,4319,103
2011,E11  1,E11  1,Total,4977,4838,139
2011,E11  2,E11  2,Total,5103,4960,143
2011,E11  3,E11  3,Total,6359,6225,134
2011,E11  4,E11  4,Total,5602,5463,139
2011,E12  5,E12  5,Total,5658,5551,107
2011,E12  6,E12  6,Total,7364,7258,106
2011,E13  0,E13  0,Total,6303,6188,115
2011,E13  8,E13  8,Total,4927,4816,111
2011,E13  9,E13  9,Total,4777,4663,114
2011,E14  0,E14  0,Total,3756,3617,139
2011,E14  2,E14  2,Total,840,805,35
2011,E14  3,E14  3,Total,7819,7446,373
2011,E14  4,E14  4,Total,337,281,56
2011,E14  5,E14  5,Total,348,319,29
2011,E14  6,E14  6,Total,4640,4557,83
2011,E14  7,E14  7,Total,4869,4554,315
2011,E14  8,E14  8,Total,5802,5462,340
2011,E14  9,E14  9,Total,8502,7285,1217
2011,E15  1,E15  1,Total,5335,5210,125
2011,E15  2,E15  2,Total,4649,4458,191
2011,E15  3,E15  3,Total,5190,5093,97
2011,E15  4,E15  4,Total,4732,4631,101
2011,E16  1,E16  1,Total,5197,4989,208
2011,E16  2,E16  2,Total,3928,3805,123
2011,E16  3,E16  3,Total,5111,5052,59
2011,E16  4,E16  4,Total,3578,3547,31
2011,E17  3,E17  3,Total,4865,4818,47
2011,E17  4,E17  4,Total,6099,5954,145
2011,E17  5,E17  5,Total,6329,6231,98
2011,E17  6,E17  6,Total,6708,6619,89
2011,E17  7,E17  7,Total,4267,4194,73
2011,E17  8,E17  8,Total,5791,5644,147
2011,E17  9,E17  9,Total,5166,5060,106
2011,E18  1,E18  1,Total,3328,3249,79
2011,E18  2,E18  2,Total,5407,5234,173
2011,E1W  1,E1W  1,Total,1533,1353,180
2011,E1W  2,E1W  2,Total,2179,2072,107
2011,E1W  3,E1W  3,Total,2819,2623,196
2011,E2   0,E2   0,Total,4635,4570,65
2011,E2   6,E2   6,Total,3848,3777,71
2011,E2   7,E2   7,Total,3956,3884,72
2011,E2   8,E2   8,Total,3363,3310,53
2011,E2   9,E2   9,Total,3442,3395,47
2011,E3   2,E3   2,Total,6445,6125,320
2011,E3   3,E3   3,Total,3937,3843,94
2011,E3   4,E3   4,Total,5528,5422,106
2011,E3   5,E3   5,Total,5132,5038,94
2011,E4   6,E4   6,Total,7083,6981,102
2011,E4   7,E4   7,Total,4961,4862,99
2011,E4   8,E4   8,Total,5472,5428,44
2011,E4   9,E4   9,Total,6801,6667,134
2011,E5   0,E5   0,Total,6862,6718,144
2011,E5   8,E5   8,Total,6903,6683,220
2011,E5   9,E5   9,Total,5999,5827,172
2011,E6   1,E6   1,Total,4960,4888,72
2011,E6   2,E6   2,Total,5132,5064,68
2011,E6   3,E6   3,Total,6518,6418,100
2011,E6   5,E6   5,Total,4114,4016,98
2011,E6   6,E6   6,Total,3969,3894,75
2011,E7   0,E7   0,Total,4955,4867,88
2011,E7   8,E7   8,Total,5739,5654,85
2011,E7   9,E7   9,Total,5782,5659,123
2011,E8   1,E8   1,Total,3900,3798,102
2011,E8   2,E8   2,Total,4464,4360,104
2011,E8   3,E8   3,Total,4713,4603,110
2011,E8   4,E8   4,Total,4559,4493,66
2011,E9   5,E9   5,Total,5195,5102,93
2011,E9   6,E9   6,Total,4951,4844,107
2011,E9   7,E9   7,Total,5864,5762,102
2011,EC1A 4,EC1A 4,Total,140,106,34
2011,EC1A 7,EC1A 7,Total,336,246,90
2011,EC1A 9,EC1A 9,Total,329,227,102
2011,EC1M 3,EC1M 3,Total,226,208,18
2011,EC1M 5,EC1M 5,Total,627,525,102
2011,EC1M 6,EC1M 6,Total,252,201,51
2011,EC1M 7,EC1M 7,Total,103,96,7
2011,EC1N 7,EC1N 7,Total,993,957,36
2011,EC1N 8,EC1N 8,Total,336,302,34
2011,EC1R 0,EC1R 0,Total,685,645,40
2011,EC1R 1,EC1R 1,Total,547,506,41
2011,EC1R 3,EC1R 3,Total,175,159,16
2011,EC1R 4,EC1R 4,Total,798,748,50
2011,EC1R 5,EC1R 5,Total,439,399,40
2011,EC1V 0,EC1V 0,Total,1085,1006,79
2011,EC1V 1,EC1V 1,Total,135,127,8
2011,EC1V 2,EC1V 2,Total,65,60,5
2011,EC1V 3,EC1V 3,Total,1328,1269,59
2011,EC1V 4,EC1V 4,Total,799,684,115
2011,EC1V 7,EC1V 7,Total,1327,1243,84
2011,EC1V 8,EC1V 8,Total,854,801,53
2011,EC1V 9,EC1V 9,Total,862,826,36
2011,EC1Y 0,EC1Y 0,Total,722,705,17
2011,EC1Y 2,EC1Y 2,Total,241,132,109
2011,EC1Y 4,EC1Y 4,Total,127,92,35
2011,EC1Y 8,EC1Y 8,Total,995,971,24
2011,EC2A 3,EC2A 3,Total,307,290,17
2011,EC2A 4,EC2A 4,Total,449,424,25
2011,EC2Y 8,EC2Y 8,Total,2210,1893,317
2011,EC3R 8,EC3R 8,Total,226,150,76
2011,EC4A 1,EC4A 1,Total,164,110,54
2011,EC4V 3,EC4V 3,Total,383,238,145
2011,EC4V 5,EC4V 5,Total,237,147,90
2011,EC4Y 7,EC4Y 7,Total,334,219,115
2011,EN1  1,EN1  1,Total,4868,4748,120
2011,EN1  2,EN1  2,Total,3039,2960,79
2011,EN1  3,EN1  3,Total,4811,4697,114
2011,EN1  4,EN1  4,Total,5271,5173,98
2011,EN10 6,EN10 6,Total,4617,4437,180
2011,EN10 7,EN10 7,Total,2426,2347,79
2011,EN11 0,EN11 0,Total,2664,2520,144
2011,EN11 8,EN11 8,Total,3282,3100,182
2011,EN11 9,EN11 9,Total,3162,3102,60
2011,EN2  0,EN2  0,Total,4199,4073,126
2011,EN2  6,EN2  6,Total,1930,1850,80
2011,EN2  7,EN2  7,Total,3099,3006,93
2011,EN2  8,EN2  8,Total,3256,3158,98
2011,EN2  9,EN2  9,Total,652,626,26
2011,EN3  4,EN3  4,Total,4415,4335,80
2011,EN3  5,EN3  5,Total,5847,5750,97
2011,EN3  6,EN3  6,Total,7474,7347,127
2011,EN3  7,EN3  7,Total,3735,3676,59
2011,EN4  0,EN4  0,Total,1897,1834,63
2011,EN4  8,EN4  8,Total,4937,4871,66
2011,EN4  9,EN4  9,Total,3386,3318,68
2011,EN5  1,EN5  1,Total,2796,2758,38
2011,EN5  2,EN5  2,Total,5491,5356,135
2011,EN5  3,EN5  3,Total,1460,1418,42
2011,EN5  4,EN5  4,Total,2302,2196,106
2011,EN5  5,EN5  5,Total,3958,3813,145
2011,EN6  1,EN6  1,Total,2837,2712,125
2011,EN6  2,EN6  2,Total,2903,2845,58
2011,EN6  3,EN6  3,Total,2163,2093,70
2011,EN6  4,EN6  4,Total,2230,2093,137
2011,EN6  5,EN6  5,Total,2205,2125,80
2011,EN7  5,EN7  5,Total,2920,2844,76
2011,EN7  6,EN7  6,Total,5577,5468,109
2011,EN8  0,EN8  0,Total,4131,3960,171
2011,EN8  7,EN8  7,Total,3160,3021,139
2011,EN8  8,EN8  8,Total,4819,4583,236
2011,EN8  9,EN8  9,Total,3571,3368,203
2011,EN9  1,EN9  1,Total,3616,3482,134
2011,EN9  2,EN9  2,Total,2084,2012,72
2011,EN9  3,EN9  3,Total,4833,4677,156
2011,EX1  1,EX1  1,Total,831,772,59
2011,EX1  2,EX1  2,Total,4016,3870,146
2011,EX1  3,EX1  3,Total,4670,4582,88
2011,EX10 0,EX10 0,Total,2156,1953,203
2011,EX10 8,EX10 8,Total,2272,1838,434
2011,EX10 9,EX10 9,Total,4559,4286,273
2011,EX11 1,EX11 1,Total,3513,3321,192
2011,EX12 2,EX12 2,Total,4089,3564,525
2011,EX12 3,EX12 3,Total,1148,821,327
2011,EX12 4,EX12 4,Total,266,220,46
2011,EX13 5,EX13 5,Total,3411,3191,220
2011,EX13 7,EX13 7,Total,1844,1675,169
2011,EX13 8,EX13 8,Total,284,253,31
2011,EX14 1,EX14 1,Total,3007,2854,153
2011,EX14 2,EX14 2,Total,2493,2440,53
2011,EX14 3,EX14 3,Total,1627,1566,61
2011,EX14 4,EX14 4,Total,1163,1089,74
2011,EX14 9,EX14 9,Total,1351,1249,102
2011,EX15 1,EX15 1,Total,3753,3648,105
2011,EX15 2,EX15 2,Total,2469,2386,83
2011,EX15 3,EX15 3,Total,2905,2779,126
2011,EX16 4,EX16 4,Total,2651,2564,87
2011,EX16 5,EX16 5,Total,2218,2165,53
2011,EX16 6,EX16 6,Total,4346,4211,135
2011,EX16 7,EX16 7,Total,1832,1761,71
2011,EX16 8,EX16 8,Total,1725,1632,93
2011,EX16 9,EX16 9,Total,1596,1483,113
2011,EX17 1,EX17 1,Total,964,947,17
2011,EX17 2,EX17 2,Total,1036,1006,30
2011,EX17 3,EX17 3,Total,1963,1892,71
2011,EX17 4,EX17 4,Total,1332,1280,52
2011,EX17 5,EX17 5,Total,1383,1319,64
2011,EX17 6,EX17 6,Total,1843,1756,87
2011,EX18 7,EX18 7,Total,1524,1379,145
2011,EX19 8,EX19 8,Total,1725,1590,135
2011,EX2  4,EX2  4,Total,3176,3036,140
2011,EX2  5,EX2  5,Total,3795,3724,71
2011,EX2  6,EX2  6,Total,2311,2259,52
2011,EX2  7,EX2  7,Total,2220,2174,46
2011,EX2  8,EX2  8,Total,3613,3485,128
2011,EX2  9,EX2  9,Total,3223,3028,195
2011,EX20 1,EX20 1,Total,3693,3406,287
2011,EX20 2,EX20 2,Total,2090,1933,157
2011,EX20 3,EX20 3,Total,2007,1838,169
2011,EX20 4,EX20 4,Total,1433,1266,167
2011,EX21 5,EX21 5,Total,2059,1855,204
2011,EX22 6,EX22 6,Total,2758,2493,265
2011,EX22 7,EX22 7,Total,2158,1905,253
2011,EX23 0,EX23 0,Total,1834,1456,378
2011,EX23 8,EX23 8,Total,3743,3409,334
2011,EX23 9,EX23 9,Total,2567,2045,522
2011,EX24 6,EX24 6,Total,1890,1707,183
2011,EX3  0,EX3  0,Total,2586,2407,179
2011,EX31 1,EX31 1,Total,1874,1767,107
2011,EX31 2,EX31 2,Total,2820,2706,114
2011,EX31 3,EX31 3,Total,3640,3457,183
2011,EX31 4,EX31 4,Total,2987,2662,325
2011,EX32 0,EX32 0,Total,2269,2115,154
2011,EX32 7,EX32 7,Total,3092,2937,155
2011,EX32 8,EX32 8,Total,2898,2769,129
2011,EX32 9,EX32 9,Total,2339,2228,111
2011,EX33 1,EX33 1,Total,3025,2420,605
2011,EX33 2,EX33 2,Total,2197,2041,156
2011,EX34 0,EX34 0,Total,1395,1193,202
2011,EX34 7,EX34 7,Total,1210,715,495
2011,EX34 8,EX34 8,Total,3053,2745,308
2011,EX34 9,EX34 9,Total,3364,2872,492
2011,EX35 6,EX35 6,Total,1003,715,288
2011,EX36 3,EX36 3,Total,1813,1678,135
2011,EX36 4,EX36 4,Total,2182,2025,157
2011,EX37 9,EX37 9,Total,1585,1379,206
2011,EX38 7,EX38 7,Total,1916,1839,77
2011,EX38 8,EX38 8,Total,1766,1632,134
2011,EX39 1,EX39 1,Total,5339,4616,723
2011,EX39 2,EX39 2,Total,2093,1956,137
2011,EX39 3,EX39 3,Total,4031,3884,147
2011,EX39 4,EX39 4,Total,3233,2917,316
2011,EX39 5,EX39 5,Total,2859,2562,297
2011,EX39 6,EX39 6,Total,1028,838,190
2011,EX4  0,EX4  0,Total,127,122,5
2011,EX4  1,EX4  1,Total,4027,3893,134
2011,EX4  2,EX4  2,Total,3373,3287,86
2011,EX4  3,EX4  3,Total,1265,1192,73
2011,EX4  4,EX4  4,Total,3040,2869,171
2011,EX4  5,EX4  5,Total,1370,1341,29
2011,EX4  6,EX4  6,Total,2742,2609,133
2011,EX4  7,EX4  7,Total,2167,2116,51
2011,EX4  8,EX4  8,Total,2598,2531,67
2011,EX4  9,EX4  9,Total,1649,1623,26
2011,EX5  1,EX5  1,Total,1604,1546,58
2011,EX5  2,EX5  2,Total,2000,1930,70
2011,EX5  3,EX5  3,Total,964,924,40
2011,EX5  4,EX5  4,Total,2248,2169,79
2011,EX5  5,EX5  5,Total,1286,1234,52
2011,EX6  6,EX6  6,Total,1362,1257,105
2011,EX6  7,EX6  7,Total,1845,1695,150
2011,EX6  8,EX6  8,Total,3112,2967,145
2011,EX7  0,EX7  0,Total,2688,2432,256
2011,EX7  9,EX7  9,Total,3506,3203,303
2011,EX8  1,EX8  1,Total,3802,3347,455
2011,EX8  2,EX8  2,Total,3912,3585,327
2011,EX8  3,EX8  3,Total,2559,2472,87
2011,EX8  4,EX8  4,Total,4254,4137,117
2011,EX8  5,EX8  5,Total,2873,2771,102
2011,EX9  6,EX9  6,Total,2764,2511,253
2011,EX9  7,EX9  7,Total,816,721,95
2011,FY1  1,FY1  1,Total,205,161,44
2011,FY1  2,FY1  2,Total,4096,3628,468
2011,FY1  3,FY1  3,Total,2408,2120,288
2011,FY1  4,FY1  4,Total,3543,3011,532
2011,FY1  5,FY1  5,Total,3194,2785,409
2011,FY1  6,FY1  6,Total,4060,3720,340
2011,FY2  0,FY2  0,Total,6965,6675,290
2011,FY2  9,FY2  9,Total,4800,4456,344
2011,FY3  0,FY3  0,Total,798,767,31
2011,FY3  7,FY3  7,Total,5139,4857,282
2011,FY3  8,FY3  8,Total,4506,4271,235
2011,FY3  9,FY3  9,Total,4617,4371,246
2011,FY4  1,FY4  1,Total,4234,3733,501
2011,FY4  2,FY4  2,Total,3490,3340,150
2011,FY4  3,FY4  3,Total,4849,4636,213
2011,FY4  4,FY4  4,Total,5794,5528,266
2011,FY4  5,FY4  5,Total,2386,2300,86
2011,FY5  1,FY5  1,Total,4052,3670,382
2011,FY5  2,FY5  2,Total,5692,5490,202
2011,FY5  3,FY5  3,Total,5510,5237,273
2011,FY5  4,FY5  4,Total,3730,3604,126
2011,FY5  5,FY5  5,Total,2499,2407,92
2011,FY6  0,FY6  0,Total,3461,3244,217
2011,FY6  7,FY6  7,Total,6012,5735,277
2011,FY6  8,FY6  8,Total,2587,2448,139
2011,FY6  9,FY6  9,Total,1223,1174,49
2011,FY7  6,FY7  6,Total,3834,3304,530
2011,FY7  7,FY7  7,Total,3934,3741,193
2011,FY7  8,FY7  8,Total,4319,4128,191
2011,FY8  1,FY8  1,Total,5246,4657,589
2011,FY8  2,FY8  2,Total,4778,4335,443
2011,FY8  3,FY8  3,Total,4994,4790,204
2011,FY8  4,FY8  4,Total,5073,4832,241
2011,FY8  5,FY8  5,Total,3171,2820,351
2011,GL1  1,GL1  1,Total,1378,1045,333
2011,GL1  2,GL1  2,Total,2131,1899,232
2011,GL1  3,GL1  3,Total,2960,2680,280
2011,GL1  4,GL1  4,Total,5037,4607,430
2011,GL1  5,GL1  5,Total,4474,4191,283
2011,GL10 2,GL10 2,Total,2925,2843,82
2011,GL10 3,GL10 3,Total,3078,2957,121
2011,GL11 4,GL11 4,Total,2807,2693,114
2011,GL11 5,GL11 5,Total,3540,3446,94
2011,GL11 6,GL11 6,Total,1689,1631,58
2011,GL12 7,GL12 7,Total,2786,2680,106
2011,GL12 8,GL12 8,Total,3067,3006,61
2011,GL13 9,GL13 9,Total,2591,2479,112
2011,GL14 1,GL14 1,Total,1597,1504,93
2011,GL14 2,GL14 2,Total,3712,3573,139
2011,GL14 3,GL14 3,Total,1681,1625,56
2011,GL15 4,GL15 4,Total,2198,2073,125
2011,GL15 5,GL15 5,Total,3899,3725,174
2011,GL15 6,GL15 6,Total,3206,2989,217
2011,GL16 7,GL16 7,Total,3122,3000,122
2011,GL16 8,GL16 8,Total,2926,2746,180
2011,GL17 0,GL17 0,Total,1937,1799,138
2011,GL17 9,GL17 9,Total,3001,2804,197
2011,GL18 1,GL18 1,Total,2750,2575,175
2011,GL18 2,GL18 2,Total,652,614,38
2011,GL19 3,GL19 3,Total,2570,2423,147
2011,GL19 4,GL19 4,Total,1403,1289,114
2011,GL2  0,GL2  0,Total,4990,4845,145
2011,GL2  2,GL2  2,Total,1787,1722,65
2011,GL2  3,GL2  3,Total,207,203,4
2011,GL2  4,GL2  4,Total,6611,6462,149
2011,GL2  5,GL2  5,Total,1641,1591,50
2011,GL2  7,GL2  7,Total,1918,1833,85
2011,GL2  8,GL2  8,Total,1518,1441,77
2011,GL2  9,GL2  9,Total,2923,2772,151
2011,GL20 5,GL20 5,Total,3659,3440,219
2011,GL20 6,GL20 6,Total,1181,1118,63
2011,GL20 7,GL20 7,Total,3151,3025,126
2011,GL20 8,GL20 8,Total,4614,4494,120
2011,GL3  1,GL3  1,Total,2561,2466,95
2011,GL3  2,GL3  2,Total,3314,3205,109
2011,GL3  3,GL3  3,Total,3955,3778,177
2011,GL3  4,GL3  4,Total,3694,3533,161
2011,GL4  0,GL4  0,Total,5335,5224,111
2011,GL4  3,GL4  3,Total,1399,1347,52
2011,GL4  4,GL4  4,Total,4277,4155,122
2011,GL4  5,GL4  5,Total,3565,3517,48
2011,GL4  6,GL4  6,Total,4621,4426,195
2011,GL4  8,GL4  8,Total,1116,1076,40
2011,GL5  1,GL5  1,Total,3631,3490,141
2011,GL5  2,GL5  2,Total,2156,2005,151
2011,GL5  3,GL5  3,Total,1935,1861,74
2011,GL5  4,GL5  4,Total,4625,4469,156
2011,GL5  5,GL5  5,Total,1643,1540,103
2011,GL50 1,GL50 1,Total,730,616,114
2011,GL50 2,GL50 2,Total,4589,4212,377
2011,GL50 3,GL50 3,Total,2125,1896,229
2011,GL50 4,GL50 4,Total,3793,3610,183
2011,GL51 0,GL51 0,Total,5397,5200,197
2011,GL51 3,GL51 3,Total,4555,4443,112
2011,GL51 4,GL51 4,Total,1107,1038,69
2011,GL51 6,GL51 6,Total,3504,3369,135
2011,GL51 7,GL51 7,Total,2902,2814,88
2011,GL51 8,GL51 8,Total,2952,2838,114
2011,GL51 9,GL51 9,Total,2512,2440,72
2011,GL52 2,GL52 2,Total,2774,2546,228
2011,GL52 3,GL52 3,Total,2533,2415,118
2011,GL52 5,GL52 5,Total,3767,3654,113
2011,GL52 6,GL52 6,Total,4429,4207,222
2011,GL52 7,GL52 7,Total,648,636,12
2011,GL52 8,GL52 8,Total,4385,4247,138
2011,GL52 9,GL52 9,Total,1672,1600,72
2011,GL53 0,GL53 0,Total,1829,1792,37
2011,GL53 7,GL53 7,Total,2774,2637,137
2011,GL53 8,GL53 8,Total,2265,2182,83
2011,GL53 9,GL53 9,Total,1826,1734,92
2011,GL54 1,GL54 1,Total,1724,1410,314
2011,GL54 2,GL54 2,Total,2713,2444,269
2011,GL54 3,GL54 3,Total,1852,1620,232
2011,GL54 4,GL54 4,Total,1341,1224,117
2011,GL54 5,GL54 5,Total,3560,3191,369
2011,GL55 6,GL55 6,Total,2822,2451,371
2011,GL56 0,GL56 0,Total,2785,2444,341
2011,GL56 9,GL56 9,Total,1736,1471,265
2011,GL6  0,GL6  0,Total,2868,2710,158
2011,GL6  6,GL6  6,Total,1915,1786,129
2011,GL6  7,GL6  7,Total,1822,1639,183
2011,GL6  8,GL6  8,Total,2847,2727,120
2011,GL6  9,GL6  9,Total,1731,1610,121
2011,GL7  1,GL7  1,Total,6414,6210,204
2011,GL7  2,GL7  2,Total,2372,2272,100
2011,GL7  3,GL7  3,Total,2291,2102,189
2011,GL7  4,GL7  4,Total,1923,1822,101
2011,GL7  5,GL7  5,Total,3482,3087,395
2011,GL7  6,GL7  6,Total,2143,1791,352
2011,GL7  7,GL7  7,Total,968,886,82
2011,GL8  8,GL8  8,Total,3974,3694,280
2011,GL9  1,GL9  1,Total,1131,1089,42
2011,GU1  1,GU1  1,Total,4461,4236,225
2011,GU1  2,GU1  2,Total,3812,3622,190
2011,GU1  3,GU1  3,Total,2393,2185,208
2011,GU1  4,GU1  4,Total,2536,2329,207
2011,GU10 1,GU10 1,Total,1980,1935,45
2011,GU10 2,GU10 2,Total,1147,1084,63
2011,GU10 3,GU10 3,Total,1687,1604,83
2011,GU10 4,GU10 4,Total,2691,2604,87
2011,GU10 5,GU10 5,Total,1510,1448,62
2011,GU11 1,GU11 1,Total,2711,2508,203
2011,GU11 2,GU11 2,Total,1181,1079,102
2011,GU11 3,GU11 3,Total,5262,5059,203
2011,GU12 4,GU12 4,Total,5951,5696,255
2011,GU12 5,GU12 5,Total,3402,3339,63
2011,GU12 6,GU12 6,Total,3926,3844,82
2011,GU14 0,GU14 0,Total,3278,3183,95
2011,GU14 6,GU14 6,Total,4133,3955,178
2011,GU14 7,GU14 7,Total,2691,2579,112
2011,GU14 8,GU14 8,Total,6229,6107,122
2011,GU14 9,GU14 9,Total,5935,5840,95
2011,GU15 1,GU15 1,Total,3834,3762,72
2011,GU15 2,GU15 2,Total,3817,3656,161
2011,GU15 3,GU15 3,Total,2945,2740,205
2011,GU15 4,GU15 4,Total,3059,2918,141
2011,GU16 6,GU16 6,Total,4129,4012,117
2011,GU16 7,GU16 7,Total,823,801,22
2011,GU16 8,GU16 8,Total,2995,2951,44
2011,GU16 9,GU16 9,Total,1459,1438,21
2011,GU17 0,GU17 0,Total,2684,2649,35
2011,GU17 9,GU17 9,Total,1584,1540,44
2011,GU18 5,GU18 5,Total,2848,2778,70
2011,GU19 5,GU19 5,Total,2409,2332,77
2011,GU2  4,GU2  4,Total,1371,1288,83
2011,GU2  7,GU2  7,Total,2786,2679,107
2011,GU2  8,GU2  8,Total,3274,3162,112
2011,GU2  9,GU2  9,Total,4805,4644,161
2011,GU20 6,GU20 6,Total,1896,1782,114
2011,GU21 2,GU21 2,Total,4638,4538,100
2011,GU21 3,GU21 3,Total,4717,4638,79
2011,GU21 4,GU21 4,Total,3815,3723,92
2011,GU21 5,GU21 5,Total,3169,3076,93
2011,GU21 6,GU21 6,Total,1190,1085,105
2011,GU21 7,GU21 7,Total,926,903,23
2011,GU21 8,GU21 8,Total,1742,1717,25
2011,GU22 0,GU22 0,Total,2771,2701,70
2011,GU22 7,GU22 7,Total,4232,4035,197
2011,GU22 8,GU22 8,Total,3595,3466,129
2011,GU22 9,GU22 9,Total,3163,3071,92
2011,GU23 6,GU23 6,Total,1616,1532,84
2011,GU23 7,GU23 7,Total,1172,1142,30
2011,GU24 0,GU24 0,Total,1698,1590,108
2011,GU24 8,GU24 8,Total,1886,1761,125
2011,GU24 9,GU24 9,Total,3063,2998,65
2011,GU25 4,GU25 4,Total,2357,2131,226
2011,GU26 6,GU26 6,Total,3135,2977,158
2011,GU27 1,GU27 1,Total,2960,2844,116
2011,GU27 2,GU27 2,Total,2237,2122,115
2011,GU27 3,GU27 3,Total,2437,2327,110
2011,GU28 0,GU28 0,Total,1842,1660,182
2011,GU28 9,GU28 9,Total,1283,1164,119
2011,GU29 0,GU29 0,Total,1588,1434,154
2011,GU29 9,GU29 9,Total,2988,2837,151
2011,GU3  1,GU3  1,Total,937,914,23
2011,GU3  2,GU3  2,Total,1110,1092,18
2011,GU3  3,GU3  3,Total,2569,2482,87
2011,GU30 7,GU30 7,Total,4038,3783,255
2011,GU31 4,GU31 4,Total,3361,3294,67
2011,GU31 5,GU31 5,Total,1652,1531,121
2011,GU32 1,GU32 1,Total,1401,1322,79
2011,GU32 2,GU32 2,Total,1473,1425,48
2011,GU32 3,GU32 3,Total,2286,2194,92
2011,GU33 6,GU33 6,Total,804,770,34
2011,GU33 7,GU33 7,Total,2659,2594,65
2011,GU34 1,GU34 1,Total,2978,2882,96
2011,GU34 2,GU34 2,Total,4337,4241,96
2011,GU34 3,GU34 3,Total,1109,1042,67
2011,GU34 4,GU34 4,Total,1605,1500,105
2011,GU34 5,GU34 5,Total,2736,2618,118
2011,GU35 0,GU35 0,Total,4503,4247,256
2011,GU35 8,GU35 8,Total,2400,2291,109
2011,GU35 9,GU35 9,Total,2653,2568,85
2011,GU4  7,GU4  7,Total,4622,4520,102
2011,GU4  8,GU4  8,Total,2222,2143,79
2011,GU46 6,GU46 6,Total,4480,4417,63
2011,GU46 7,GU46 7,Total,1431,1416,15
2011,GU47 0,GU47 0,Total,4273,4215,58
2011,GU47 8,GU47 8,Total,1702,1677,25
2011,GU47 9,GU47 9,Total,1636,1593,43
2011,GU5  0,GU5  0,Total,2940,2772,168
2011,GU5  9,GU5  9,Total,1826,1726,100
2011,GU51 1,GU51 1,Total,1871,1839,32
2011,GU51 2,GU51 2,Total,1076,1055,21
2011,GU51 3,GU51 3,Total,3699,3593,106
2011,GU51 4,GU51 4,Total,1701,1650,51
2011,GU51 5,GU51 5,Total,1320,1285,35
2011,GU52 0,GU52 0,Total,1013,992,21
2011,GU52 6,GU52 6,Total,3107,3041,66
2011,GU52 7,GU52 7,Total,1282,1266,16
2011,GU52 8,GU52 8,Total,1023,954,69
2011,GU6  7,GU6  7,Total,3562,3434,128
2011,GU6  8,GU6  8,Total,2731,2505,226
2011,GU7  1,GU7  1,Total,3263,3121,142
2011,GU7  2,GU7  2,Total,2707,2626,81
2011,GU7  3,GU7  3,Total,3635,3521,114
2011,GU8  4,GU8  4,Total,2345,2220,125
2011,GU8  5,GU8  5,Total,3321,3173,148
2011,GU8  6,GU8  6,Total,1638,1566,72
2011,GU9  0,GU9  0,Total,3069,2987,82
2011,GU9  7,GU9  7,Total,2512,2296,216
2011,GU9  8,GU9  8,Total,4068,3924,144
2011,GU9  9,GU9  9,Total,3223,3134,89
2011,HA0  1,HA0  1,Total,3210,3145,65
2011,HA0  2,HA0  2,Total,4399,4305,94
2011,HA0  3,HA0  3,Total,3710,3649,61
2011,HA0  4,HA0  4,Total,4041,3764,277
2011,HA1  1,HA1  1,Total,2950,2879,71
2011,HA1  2,HA1  2,Total,2988,2896,92
2011,HA1  3,HA1  3,Total,4049,3828,221
2011,HA1  4,HA1  4,Total,5055,4877,178
2011,HA2  0,HA2  0,Total,4201,4068,133
2011,HA2  6,HA2  6,Total,3016,2949,67
2011,HA2  7,HA2  7,Total,2705,2641,64
2011,HA2  8,HA2  8,Total,4655,4501,154
2011,HA2  9,HA2  9,Total,5095,5004,91
2011,HA3  0,HA3  0,Total,3690,3593,97
2011,HA3  5,HA3  5,Total,3703,3559,144
2011,HA3  6,HA3  6,Total,3312,3217,95
2011,HA3  7,HA3  7,Total,4316,4201,115
2011,HA3  8,HA3  8,Total,3705,3650,55
2011,HA3  9,HA3  9,Total,4882,4814,68
2011,HA4  0,HA4  0,Total,3648,3578,70
2011,HA4  6,HA4  6,Total,4385,4236,149
2011,HA4  7,HA4  7,Total,4326,4181,145
2011,HA4  8,HA4  8,Total,3513,3364,149
2011,HA4  9,HA4  9,Total,4245,4152,93
2011,HA5  1,HA5  1,Total,3445,3376,69
2011,HA5  2,HA5  2,Total,3787,3684,103
2011,HA5  3,HA5  3,Total,4376,4278,98
2011,HA5  4,HA5  4,Total,3443,3342,101
2011,HA5  5,HA5  5,Total,3070,2980,90
2011,HA6  1,HA6  1,Total,3733,3539,194
2011,HA6  2,HA6  2,Total,3514,3267,247
2011,HA6  3,HA6  3,Total,2159,2017,142
2011,HA7  1,HA7  1,Total,2701,2599,102
2011,HA7  2,HA7  2,Total,4032,3937,95
2011,HA7  3,HA7  3,Total,3204,3076,128
2011,HA7  4,HA7  4,Total,3591,3463,128
2011,HA8  0,HA8  0,Total,4165,4071,94
2011,HA8  5,HA8  5,Total,3896,3808,88
2011,HA8  6,HA8  6,Total,3919,3819,100
2011,HA8  7,HA8  7,Total,1948,1866,82
2011,HA8  8,HA8  8,Total,5345,5206,139
2011,HA8  9,HA8  9,Total,4272,4177,95
2011,HA9  0,HA9  0,Total,1175,1089,86
2011,HA9  6,HA9  6,Total,3256,3157,99
2011,HA9  7,HA9  7,Total,3022,2900,122
2011,HA9  8,HA9  8,Total,4447,4335,112
2011,HA9  9,HA9  9,Total,4308,4198,110
2011,HD1  1,HD1  1,Total,215,178,37
2011,HD1  3,HD1  3,Total,2742,2528,214
2011,HD1  4,HD1  4,Total,3929,3710,219
2011,HD1  5,HD1  5,Total,1292,1228,64
2011,HD1  6,HD1  6,Total,1380,1245,135
2011,HD2  1,HD2  1,Total,7019,6739,280
2011,HD2  2,HD2  2,Total,5564,5332,232
2011,HD3  3,HD3  3,Total,6877,6584,293
2011,HD3  4,HD3  4,Total,6841,6460,381
2011,HD4  5,HD4  5,Total,5234,4994,240
2011,HD4  6,HD4  6,Total,4972,4731,241
2011,HD4  7,HD4  7,Total,3617,3470,147
2011,HD5  0,HD5  0,Total,2293,2236,57
2011,HD5  8,HD5  8,Total,6341,6063,278
2011,HD5  9,HD5  9,Total,5463,5258,205
2011,HD6  1,HD6  1,Total,1422,1343,79
2011,HD6  2,HD6  2,Total,3552,3429,123
2011,HD6  3,HD6  3,Total,5518,5328,190
2011,HD6  4,HD6  4,Total,2299,2240,59
2011,HD7  4,HD7  4,Total,3724,3535,189
2011,HD7  5,HD7  5,Total,4526,4290,236
2011,HD7  6,HD7  6,Total,2094,1995,99
2011,HD8  0,HD8  0,Total,4621,4456,165
2011,HD8  8,HD8  8,Total,5096,4927,169
2011,HD8  9,HD8  9,Total,4595,4467,128
2011,HD9  1,HD9  1,Total,3212,3071,141
2011,HD9  2,HD9  2,Total,1932,1835,97
2011,HD9  3,HD9  3,Total,1711,1645,66
2011,HD9  4,HD9  4,Total,1761,1663,98
2011,HD9  5,HD9  5,Total,1985,1904,81
2011,HD9  6,HD9  6,Total,2891,2753,138
2011,HD9  7,HD9  7,Total,2161,2071,90
2011,HG1  1,HG1  1,Total,726,661,65
2011,HG1  2,HG1  2,Total,3561,3365,196
2011,HG1  3,HG1  3,Total,3240,3169,71
2011,HG1  4,HG1  4,Total,5653,5448,205
2011,HG1  5,HG1  5,Total,3117,2894,223
2011,HG2  0,HG2  0,Total,4006,3730,276
2011,HG2  7,HG2  7,Total,4875,4741,134
2011,HG2  8,HG2  8,Total,3672,3507,165
2011,HG2  9,HG2  9,Total,2382,2265,117
2011,HG3  1,HG3  1,Total,2258,2154,104
2011,HG3  2,HG3  2,Total,4793,4623,170
2011,HG3  3,HG3  3,Total,1957,1839,118
2011,HG3  4,HG3  4,Total,957,890,67
2011,HG3  5,HG3  5,Total,1728,1548,180
2011,HG4  1,HG4  1,Total,3785,3590,195
2011,HG4  2,HG4  2,Total,3581,3369,212
2011,HG4  3,HG4  3,Total,1871,1750,121
2011,HG4  4,HG4  4,Total,1220,1095,125
2011,HG4  5,HG4  5,Total,1121,1080,41
2011,HG5  0,HG5  0,Total,3946,3819,127
2011,HG5  8,HG5  8,Total,2265,2157,108
2011,HG5  9,HG5  9,Total,1902,1830,72
2011,HP1  1,HP1  1,Total,3800,3355,445
2011,HP1  2,HP1  2,Total,3692,3603,89
2011,HP1  3,HP1  3,Total,3352,3288,64
2011,HP10 0,HP10 0,Total,2335,2271,64
2011,HP10 8,HP10 8,Total,2177,2144,33
2011,HP10 9,HP10 9,Total,3386,3307,79
2011,HP11 1,HP11 1,Total,3265,3132,133
2011,HP11 2,HP11 2,Total,2081,1974,107
2011,HP12 3,HP12 3,Total,4502,4315,187
2011,HP12 4,HP12 4,Total,4240,4154,86
2011,HP13 5,HP13 5,Total,5571,5255,316
2011,HP13 6,HP13 6,Total,4384,4240,144
2011,HP13 7,HP13 7,Total,7410,7238,172
2011,HP14 3,HP14 3,Total,3983,3859,124
2011,HP14 4,HP14 4,Total,3350,3147,203
2011,HP15 6,HP15 6,Total,3307,3198,109
2011,HP15 7,HP15 7,Total,3691,3631,60
2011,HP16 0,HP16 0,Total,2847,2759,88
2011,HP16 9,HP16 9,Total,2063,1968,95
2011,HP17 0,HP17 0,Total,501,477,24
2011,HP17 8,HP17 8,Total,3471,3345,126
2011,HP17 9,HP17 9,Total,388,360,28
2011,HP18 0,HP18 0,Total,2359,2257,102
2011,HP18 9,HP18 9,Total,3089,2959,130
2011,HP19 0,HP19 0,Total,1021,1002,19
2011,HP19 7,HP19 7,Total,2999,2904,95
2011,HP19 8,HP19 8,Total,1451,1401,50
2011,HP19 9,HP19 9,Total,4288,4121,167
2011,HP2  4,HP2  4,Total,4771,4513,258
2011,HP2  5,HP2  5,Total,5444,5346,98
2011,HP2  6,HP2  6,Total,3296,3233,63
2011,HP2  7,HP2  7,Total,3110,3036,74
2011,HP20 1,HP20 1,Total,3248,3160,88
2011,HP20 2,HP20 2,Total,2948,2831,117
2011,HP21 7,HP21 7,Total,4108,3985,123
2011,HP21 8,HP21 8,Total,5160,5032,128
2011,HP21 9,HP21 9,Total,4511,4361,150
2011,HP22 4,HP22 4,Total,2215,2101,114
2011,HP22 5,HP22 5,Total,5420,5220,200
2011,HP22 6,HP22 6,Total,2692,2601,91
2011,HP23 4,HP23 4,Total,2434,2371,63
2011,HP23 5,HP23 5,Total,3396,3314,82
2011,HP23 6,HP23 6,Total,1554,1479,75
2011,HP27 0,HP27 0,Total,2771,2688,83
2011,HP27 9,HP27 9,Total,2486,2415,71
2011,HP3  0,HP3  0,Total,3062,2980,82
2011,HP3  8,HP3  8,Total,3908,3851,57
2011,HP3  9,HP3  9,Total,5967,5839,128
2011,HP4  1,HP4  1,Total,3069,2923,146
2011,HP4  2,HP4  2,Total,3462,3327,135
2011,HP4  3,HP4  3,Total,4000,3887,113
2011,HP5  1,HP5  1,Total,2959,2872,87
2011,HP5  2,HP5  2,Total,4680,4521,159
2011,HP5  3,HP5  3,Total,3041,2913,128
2011,HP6  5,HP6  5,Total,2428,2322,106
2011,HP6  6,HP6  6,Total,3304,3232,72
2011,HP7  0,HP7  0,Total,1933,1822,111
2011,HP7  9,HP7  9,Total,2638,2578,60
2011,HP8  4,HP8  4,Total,2785,2681,104
2011,HP9  1,HP9  1,Total,3673,3558,115
2011,HP9  2,HP9  2,Total,3321,3164,157
2011,HR1  1,HR1  1,Total,5840,5691,149
2011,HR1  2,HR1  2,Total,2766,2593,173
2011,HR1  3,HR1  3,Total,2649,2555,94
2011,HR1  4,HR1  4,Total,2658,2521,137
2011,HR2  0,HR2  0,Total,2067,1851,216
2011,HR2  6,HR2  6,Total,3531,3438,93
2011,HR2  7,HR2  7,Total,6622,6472,150
2011,HR2  8,HR2  8,Total,2164,2002,162
2011,HR2  9,HR2  9,Total,2474,2387,87
2011,HR3  5,HR3  5,Total,2506,2211,295
2011,HR3  6,HR3  6,Total,1435,1291,144
2011,HR4  0,HR4  0,Total,4858,4712,146
2011,HR4  7,HR4  7,Total,2370,2286,84
2011,HR4  8,HR4  8,Total,2624,2481,143
2011,HR4  9,HR4  9,Total,3784,3644,140
2011,HR5  3,HR5  3,Total,2245,2030,215
2011,HR6  0,HR6  0,Total,2055,1907,148
2011,HR6  8,HR6  8,Total,4950,4737,213
2011,HR6  9,HR6  9,Total,2476,2264,212
2011,HR7  4,HR7  4,Total,3328,3131,197
2011,HR8  1,HR8  1,Total,2149,1994,155
2011,HR8  2,HR8  2,Total,4314,4137,177
2011,HR9  5,HR9  5,Total,3335,3096,239
2011,HR9  6,HR9  6,Total,2059,1866,193
2011,HR9  7,HR9  7,Total,4440,4183,257
2011,HU1  1,HU1  1,Total,708,636,72
2011,HU1  2,HU1  2,Total,1420,1362,58
2011,HU1  3,HU1  3,Total,131,124,7
2011,HU10 6,HU10 6,Total,4844,4677,167
2011,HU10 7,HU10 7,Total,3558,3420,138
2011,HU11 4,HU11 4,Total,3627,3530,97
2011,HU11 5,HU11 5,Total,1658,1609,49
2011,HU12 0,HU12 0,Total,2440,2294,146
2011,HU12 8,HU12 8,Total,4973,4815,158
2011,HU12 9,HU12 9,Total,3871,3762,109
2011,HU13 0,HU13 0,Total,3192,3093,99
2011,HU13 9,HU13 9,Total,3311,3213,98
2011,HU14 3,HU14 3,Total,3592,3467,125
2011,HU15 1,HU15 1,Total,5276,5107,169
2011,HU15 2,HU15 2,Total,4756,4610,146
2011,HU16 4,HU16 4,Total,3131,3022,109
2011,HU16 5,HU16 5,Total,4013,3897,116
2011,HU17 0,HU17 0,Total,4781,4605,176
2011,HU17 5,HU17 5,Total,1182,1152,30
2011,HU17 7,HU17 7,Total,3747,3620,127
2011,HU17 8,HU17 8,Total,5028,4842,186
2011,HU17 9,HU17 9,Total,4631,4514,117
2011,HU18 1,HU18 1,Total,4114,3886,228
2011,HU19 2,HU19 2,Total,3338,3098,240
2011,HU2  0,HU2  0,Total,548,536,12
2011,HU2  8,HU2  8,Total,1043,984,59
2011,HU2  9,HU2  9,Total,663,650,13
2011,HU20 3,HU20 3,Total,430,422,8
2011,HU3  1,HU3  1,Total,3412,3196,216
2011,HU3  2,HU3  2,Total,2965,2842,123
2011,HU3  3,HU3  3,Total,2196,2073,123
2011,HU3  5,HU3  5,Total,1280,1244,36
2011,HU3  6,HU3  6,Total,3749,3573,176
2011,HU4  6,HU4  6,Total,5596,5563,33
2011,HU4  7,HU4  7,Total,4695,4639,56
2011,HU5  1,HU5  1,Total,2404,2290,114
2011,HU5  2,HU5  2,Total,4131,3876,255
2011,HU5  3,HU5  3,Total,4876,4602,274
2011,HU5  4,HU5  4,Total,3928,3834,94
2011,HU5  5,HU5  5,Total,8288,8031,257
2011,HU6  0,HU6  0,Total,225,220,5
2011,HU6  7,HU6  7,Total,5047,4857,190
2011,HU6  8,HU6  8,Total,4141,4023,118
2011,HU6  9,HU6  9,Total,5403,5014,389
2011,HU7  0,HU7  0,Total,841,820,21
2011,HU7  3,HU7  3,Total,2733,2645,88
2011,HU7  4,HU7  4,Total,9894,9650,244
2011,HU7  5,HU7  5,Total,2018,1963,55
2011,HU7  6,HU7  6,Total,2140,2093,47
2011,HU8  0,HU8  0,Total,4020,3895,125
2011,HU8  7,HU8  7,Total,1165,1110,55
2011,HU8  8,HU8  8,Total,3998,3868,130
2011,HU8  9,HU8  9,Total,6415,6258,157
2011,HU9  1,HU9  1,Total,2355,2281,74
2011,HU9  2,HU9  2,Total,2963,2827,136
2011,HU9  3,HU9  3,Total,4431,4335,96
2011,HU9  4,HU9  4,Total,5920,5783,137
2011,HU9  5,HU9  5,Total,3565,3477,88
2011,HX1  1,HX1  1,Total,411,376,35
2011,HX1  2,HX1  2,Total,2241,2037,204
2011,HX1  3,HX1  3,Total,2893,2700,193
2011,HX1  4,HX1  4,Total,2537,2344,193
2011,HX1  5,HX1  5,Total,1583,1478,105
2011,HX2  0,HX2  0,Total,3934,3827,107
2011,HX2  6,HX2  6,Total,2262,2145,117
2011,HX2  7,HX2  7,Total,2807,2741,66
2011,HX2  8,HX2  8,Total,3122,2996,126
2011,HX2  9,HX2  9,Total,3856,3793,63
2011,HX3  0,HX3  0,Total,3359,3261,98
2011,HX3  5,HX3  5,Total,3530,3437,93
2011,HX3  6,HX3  6,Total,3308,3128,180
2011,HX3  7,HX3  7,Total,4308,4183,125
2011,HX3  8,HX3  8,Total,3286,3179,107
2011,HX3  9,HX3  9,Total,3200,3120,80
2011,HX4  0,HX4  0,Total,712,693,19
2011,HX4  8,HX4  8,Total,2810,2744,66
2011,HX4  9,HX4  9,Total,1792,1758,34
2011,HX5  0,HX5  0,Total,2737,2655,82
2011,HX5  9,HX5  9,Total,2030,1950,80
2011,HX6  1,HX6  1,Total,1850,1819,31
2011,HX6  2,HX6  2,Total,3070,2933,137
2011,HX6  3,HX6  3,Total,1459,1390,69
2011,HX6  4,HX6  4,Total,2285,2185,100
2011,HX7  5,HX7  5,Total,2280,2175,105
2011,HX7  6,HX7  6,Total,1126,1081,45
2011,HX7  7,HX7  7,Total,1224,1155,69
2011,HX7  8,HX7  8,Total,1860,1772,88
2011,IG1  1,IG1  1,Total,4423,4276,147
2011,IG1  2,IG1  2,Total,6321,6186,135
2011,IG1  3,IG1  3,Total,5682,5566,116
2011,IG1  4,IG1  4,Total,4275,4127,148
2011,IG10 1,IG10 1,Total,2800,2686,114
2011,IG10 2,IG10 2,Total,4105,3971,134
2011,IG10 3,IG10 3,Total,4655,4513,142
2011,IG10 4,IG10 4,Total,2049,1981,68
2011,IG11 0,IG11 0,Total,3639,3587,52
2011,IG11 7,IG11 7,Total,6086,5945,141
2011,IG11 8,IG11 8,Total,3061,2974,87
2011,IG11 9,IG11 9,Total,6836,6702,134
2011,IG2  6,IG2  6,Total,4973,4799,174
2011,IG2  7,IG2  7,Total,4931,4819,112
2011,IG3  8,IG3  8,Total,5563,5441,122
2011,IG3  9,IG3  9,Total,5892,5788,104
2011,IG4  5,IG4  5,Total,2789,2734,55
2011,IG5  0,IG5  0,Total,5939,5814,125
2011,IG6  1,IG6  1,Total,3059,2973,86
2011,IG6  2,IG6  2,Total,4690,4599,91
2011,IG6  3,IG6  3,Total,2827,2763,64
2011,IG7  4,IG7  4,Total,3084,3020,64
2011,IG7  5,IG7  5,Total,3311,3180,131
2011,IG7  6,IG7  6,Total,1816,1716,100
2011,IG8  0,IG8  0,Total,3531,3403,128
2011,IG8  7,IG8  7,Total,3771,3694,77
2011,IG8  8,IG8  8,Total,3349,3268,81
2011,IG8  9,IG8  9,Total,3730,3648,82
2011,IG9  5,IG9  5,Total,3439,3251,188
2011,IG9  6,IG9  6,Total,2326,2269,57
2011,IP1  1,IP1  1,Total,419,346,73
2011,IP1  2,IP1  2,Total,2871,2648,223
2011,IP1  3,IP1  3,Total,1561,1453,108
2011,IP1  4,IP1  4,Total,3648,3535,113
2011,IP1  5,IP1  5,Total,4020,3912,108
2011,IP1  6,IP1  6,Total,4996,4913,83
2011,IP10 0,IP10 0,Total,1381,1326,55
2011,IP11 0,IP11 0,Total,2347,2298,49
2011,IP11 2,IP11 2,Total,3969,3871,98
2011,IP11 7,IP11 7,Total,3170,2931,239
2011,IP11 9,IP11 9,Total,4148,4008,140
2011,IP12 1,IP12 1,Total,3372,3162,210
2011,IP12 2,IP12 2,Total,2653,2302,351
2011,IP12 3,IP12 3,Total,1889,1657,232
2011,IP12 4,IP12 4,Total,3518,3268,250
2011,IP13 0,IP13 0,Total,1827,1681,146
2011,IP13 6,IP13 6,Total,2038,1920,118
2011,IP13 7,IP13 7,Total,1386,1273,113
2011,IP13 8,IP13 8,Total,1051,958,93
2011,IP13 9,IP13 9,Total,1832,1684,148
2011,IP14 1,IP14 1,Total,4243,4117,126
2011,IP14 2,IP14 2,Total,2760,2695,65
2011,IP14 3,IP14 3,Total,1934,1852,82
2011,IP14 4,IP14 4,Total,2522,2451,71
2011,IP14 5,IP14 5,Total,3556,3444,112
2011,IP14 6,IP14 6,Total,1795,1717,78
2011,IP15 5,IP15 5,Total,2018,1316,702
2011,IP16 4,IP16 4,Total,3375,2920,455
2011,IP17 1,IP17 1,Total,3165,2837,328
2011,IP17 2,IP17 2,Total,1280,1130,150
2011,IP17 3,IP17 3,Total,1179,905,274
2011,IP18 6,IP18 6,Total,3124,2050,1074
2011,IP19 0,IP19 0,Total,1106,1000,106
2011,IP19 8,IP19 8,Total,2993,2807,186
2011,IP19 9,IP19 9,Total,1098,882,216
2011,IP2  0,IP2  0,Total,4131,4043,88
2011,IP2  8,IP2  8,Total,3578,3428,150
2011,IP2  9,IP2  9,Total,6436,6296,140
2011,IP20 0,IP20 0,Total,1145,1072,73
2011,IP20 9,IP20 9,Total,2547,2452,95
2011,IP21 4,IP21 4,Total,2911,2767,144
2011,IP21 5,IP21 5,Total,2196,2069,127
2011,IP22 1,IP22 1,Total,2442,2277,165
2011,IP22 2,IP22 2,Total,2408,2267,141
2011,IP22 4,IP22 4,Total,4006,3888,118
2011,IP22 5,IP22 5,Total,1156,1119,37
2011,IP23 7,IP23 7,Total,1959,1840,119
2011,IP23 8,IP23 8,Total,1124,1080,44
2011,IP24 1,IP24 1,Total,4078,3909,169
2011,IP24 2,IP24 2,Total,4144,3995,149
2011,IP24 3,IP24 3,Total,3427,3195,232
2011,IP25 6,IP25 6,Total,4921,4593,328
2011,IP25 7,IP25 7,Total,3057,2889,168
2011,IP26 4,IP26 4,Total,2479,2266,213
2011,IP26 5,IP26 5,Total,1563,1440,123
2011,IP27 0,IP27 0,Total,5272,4984,288
2011,IP27 9,IP27 9,Total,3136,2697,439
2011,IP28 6,IP28 6,Total,2383,2265,118
2011,IP28 7,IP28 7,Total,4229,3936,293
2011,IP28 8,IP28 8,Total,4443,3979,464
2011,IP29 4,IP29 4,Total,1917,1826,91
2011,IP29 5,IP29 5,Total,1977,1900,77
2011,IP3  0,IP3  0,Total,4568,4375,193
2011,IP3  8,IP3  8,Total,5329,5131,198
2011,IP3  9,IP3  9,Total,5018,4901,117
2011,IP30 0,IP30 0,Total,1835,1769,66
2011,IP30 9,IP30 9,Total,4009,3880,129
2011,IP31 1,IP31 1,Total,2296,2209,87
2011,IP31 2,IP31 2,Total,3356,3258,98
2011,IP31 3,IP31 3,Total,2945,2855,90
2011,IP32 6,IP32 6,Total,3807,3723,84
2011,IP32 7,IP32 7,Total,3377,3306,71
2011,IP33 1,IP33 1,Total,2524,2378,146
2011,IP33 2,IP33 2,Total,4227,4119,108
2011,IP33 3,IP33 3,Total,4843,4720,123
2011,IP4  1,IP4  1,Total,1741,1630,111
2011,IP4  2,IP4  2,Total,3843,3582,261
2011,IP4  3,IP4  3,Total,2202,2159,43
2011,IP4  4,IP4  4,Total,3286,3206,80
2011,IP4  5,IP4  5,Total,5118,4984,134
2011,IP5  1,IP5  1,Total,2580,2497,83
2011,IP5  2,IP5  2,Total,3932,3839,93
2011,IP5  3,IP5  3,Total,1722,1680,42
2011,IP6  0,IP6  0,Total,2365,2306,59
2011,IP6  8,IP6  8,Total,2907,2808,99
2011,IP6  9,IP6  9,Total,1921,1811,110
2011,IP7  5,IP7  5,Total,2944,2855,89
2011,IP7  6,IP7  6,Total,1995,1910,85
2011,IP7  7,IP7  7,Total,1996,1859,137
2011,IP8  3,IP8  3,Total,2987,2924,63
2011,IP8  4,IP8  4,Total,1916,1864,52
2011,IP9  1,IP9  1,Total,1893,1815,78
2011,IP9  2,IP9  2,Total,2894,2809,85
2011,KT1  1,KT1  1,Total,503,463,40
2011,KT1  2,KT1  2,Total,3759,3608,151
2011,KT1  3,KT1  3,Total,4719,4593,126
2011,KT1  4,KT1  4,Total,1602,1491,111
2011,KT10 0,KT10 0,Total,3796,3673,123
2011,KT10 8,KT10 8,Total,2501,2373,128
2011,KT10 9,KT10 9,Total,2055,1870,185
2011,KT11 1,KT11 1,Total,1323,1257,66
2011,KT11 2,KT11 2,Total,3588,3368,220
2011,KT11 3,KT11 3,Total,1206,1111,95
2011,KT12 1,KT12 1,Total,2102,1955,147
2011,KT12 2,KT12 2,Total,5212,5001,211
2011,KT12 3,KT12 3,Total,3254,3100,154
2011,KT12 4,KT12 4,Total,2496,2381,115
2011,KT12 5,KT12 5,Total,3054,2881,173
2011,KT13 0,KT13 0,Total,2902,2680,222
2011,KT13 8,KT13 8,Total,3428,3206,222
2011,KT13 9,KT13 9,Total,3399,3196,203
2011,KT14 6,KT14 6,Total,2403,2320,83
2011,KT14 7,KT14 7,Total,3267,3174,93
2011,KT15 1,KT15 1,Total,4157,4040,117
2011,KT15 2,KT15 2,Total,3890,3729,161
2011,KT15 3,KT15 3,Total,3847,3746,101
2011,KT16 0,KT16 0,Total,2537,2374,163
2011,KT16 8,KT16 8,Total,2939,2787,152
2011,KT16 9,KT16 9,Total,2925,2838,87
2011,KT17 1,KT17 1,Total,2420,2346,74
2011,KT17 2,KT17 2,Total,3023,2969,54
2011,KT17 3,KT17 3,Total,1487,1456,31
2011,KT17 4,KT17 4,Total,2655,2558,97
2011,KT18 5,KT18 5,Total,3436,3351,85
2011,KT18 6,KT18 6,Total,850,812,38
2011,KT18 7,KT18 7,Total,3206,3098,108
2011,KT19 0,KT19 0,Total,3639,3564,75
2011,KT19 7,KT19 7,Total,664,653,11
2011,KT19 8,KT19 8,Total,3159,3015,144
2011,KT19 9,KT19 9,Total,6058,5963,95
2011,KT2  5,KT2  5,Total,5898,5636,262
2011,KT2  6,KT2  6,Total,3448,3356,92
2011,KT2  7,KT2  7,Total,2993,2860,133
2011,KT20 5,KT20 5,Total,4239,4139,100
2011,KT20 6,KT20 6,Total,2397,2311,86
2011,KT20 7,KT20 7,Total,2108,2028,80
2011,KT21 1,KT21 1,Total,2328,2283,45
2011,KT21 2,KT21 2,Total,3304,3201,103
2011,KT22 0,KT22 0,Total,1592,1452,140
2011,KT22 7,KT22 7,Total,3122,2986,136
2011,KT22 8,KT22 8,Total,2190,2068,122
2011,KT22 9,KT22 9,Total,3574,3509,65
2011,KT23 3,KT23 3,Total,2223,2171,52
2011,KT23 4,KT23 4,Total,2448,2394,54
2011,KT24 5,KT24 5,Total,2082,2023,59
2011,KT24 6,KT24 6,Total,1794,1717,77
2011,KT3  3,KT3  3,Total,5009,4868,141
2011,KT3  4,KT3  4,Total,1861,1813,48
2011,KT3  5,KT3  5,Total,3849,3746,103
2011,KT3  6,KT3  6,Total,4020,3912,108
2011,KT4  7,KT4  7,Total,4288,4202,86
2011,KT4  8,KT4  8,Total,7332,7214,118
2011,KT5  8,KT5  8,Total,4590,4437,153
2011,KT5  9,KT5  9,Total,3597,3531,66
2011,KT6  4,KT6  4,Total,3421,3264,157
2011,KT6  5,KT6  5,Total,3068,2967,101
2011,KT6  6,KT6  6,Total,3389,3255,134
2011,KT6  7,KT6  7,Total,4092,3970,122
2011,KT7  0,KT7  0,Total,4206,4063,143
2011,KT8  0,KT8  0,Total,1064,1019,45
2011,KT8  1,KT8  1,Total,2319,2257,62
2011,KT8  2,KT8  2,Total,3156,3076,80
2011,KT8  9,KT8  9,Total,2075,1953,122
2011,KT9  1,KT9  1,Total,3744,3673,71
2011,KT9  2,KT9  2,Total,4746,4665,81
2011,L1   0,L1   0,Total,86,81,5
2011,L1   1,L1   1,Total,130,117,13
2011,L1   2,L1   2,Total,91,84,7
2011,L1   3,L1   3,Total,187,125,62
2011,L1   4,L1   4,Total,693,625,68
2011,L1   5,L1   5,Total,1436,1333,103
2011,L1   6,L1   6,Total,284,263,21
2011,L1   7,L1   7,Total,313,308,5
2011,L1   8,L1   8,Total,726,481,245
2011,L1   9,L1   9,Total,409,370,39
2011,L10  0,L10  0,Total,227,222,5
2011,L10  1,L10  1,Total,635,615,20
2011,L10  2,L10  2,Total,639,617,22
2011,L10  3,L10  3,Total,478,467,11
2011,L10  4,L10  4,Total,1259,1224,35
2011,L10  6,L10  6,Total,696,674,22
2011,L10  7,L10  7,Total,1067,1042,25
2011,L10  8,L10  8,Total,887,878,9
2011,L10  9,L10  9,Total,654,638,16
2011,L11  0,L11  0,Total,694,685,9
2011,L11  1,L11  1,Total,990,978,12
2011,L11  2,L11  2,Total,1810,1774,36
2011,L11  3,L11  3,Total,1852,1790,62
2011,L11  4,L11  4,Total,1245,1209,36
2011,L11  5,L11  5,Total,673,662,11
2011,L11  6,L11  6,Total,509,497,12
2011,L11  7,L11  7,Total,1292,1280,12
2011,L11  8,L11  8,Total,908,897,11
2011,L11  9,L11  9,Total,961,911,50
2011,L12  0,L12  0,Total,3775,3714,61
2011,L12  1,L12  1,Total,576,558,18
2011,L12  2,L12  2,Total,486,451,35
2011,L12  3,L12  3,Total,365,357,8
2011,L12  4,L12  4,Total,1391,1341,50
2011,L12  5,L12  5,Total,1843,1807,36
2011,L12  6,L12  6,Total,1128,1073,55
2011,L12  7,L12  7,Total,927,910,17
2011,L12  8,L12  8,Total,1064,1035,29
2011,L12  9,L12  9,Total,1925,1878,47
2011,L13  0,L13  0,Total,621,610,11
2011,L13  1,L13  1,Total,722,701,21
2011,L13  2,L13  2,Total,1577,1507,70
2011,L13  3,L13  3,Total,1469,1365,104
2011,L13  4,L13  4,Total,1466,1424,42
2011,L13  5,L13  5,Total,1953,1886,67
2011,L13  6,L13  6,Total,1438,1399,39
2011,L13  7,L13  7,Total,1821,1754,67
2011,L13  8,L13  8,Total,1556,1468,88
2011,L13  9,L13  9,Total,1613,1576,37
2011,L14  0,L14  0,Total,1885,1827,58
2011,L14  1,L14  1,Total,926,908,18
2011,L14  2,L14  2,Total,975,959,16
2011,L14  3,L14  3,Total,842,817,25
2011,L14  4,L14  4,Total,768,736,32
2011,L14  5,L14  5,Total,452,438,14
2011,L14  6,L14  6,Total,1116,1092,24
2011,L14  7,L14  7,Total,1372,1330,42
2011,L14  8,L14  8,Total,1094,1046,48
2011,L14  9,L14  9,Total,1506,1471,35
2011,L15  0,L15  0,Total,1530,1461,69
2011,L15  1,L15  1,Total,1356,1273,83
2011,L15  2,L15  2,Total,981,913,68
2011,L15  3,L15  3,Total,1504,1435,69
2011,L15  4,L15  4,Total,2031,1924,107
2011,L15  5,L15  5,Total,691,647,44
2011,L15  6,L15  6,Total,990,965,25
2011,L15  7,L15  7,Total,1320,1286,34
2011,L15  8,L15  8,Total,1900,1821,79
2011,L15  9,L15  9,Total,866,818,48
2011,L16  0,L16  0,Total,324,317,7
2011,L16  1,L16  1,Total,473,467,6
2011,L16  2,L16  2,Total,1016,1002,14
2011,L16  3,L16  3,Total,985,970,15
2011,L16  4,L16  4,Total,340,337,3
2011,L16  5,L16  5,Total,612,601,11
2011,L16  6,L16  6,Total,461,460,1
2011,L16  7,L16  7,Total,889,879,10
2011,L16  8,L16  8,Total,394,389,5
2011,L16  9,L16  9,Total,281,274,7
2011,L17  0,L17  0,Total,2031,1965,66
2011,L17  1,L17  1,Total,391,378,13
2011,L17  2,L17  2,Total,670,636,34
2011,L17  3,L17  3,Total,1417,1350,67
2011,L17  4,L17  4,Total,925,858,67
2011,L17  5,L17  5,Total,708,679,29
2011,L17  6,L17  6,Total,1051,994,57
2011,L17  7,L17  7,Total,2102,1993,109
2011,L17  8,L17  8,Total,1928,1860,68
2011,L17  9,L17  9,Total,888,856,32
2011,L18  0,L18  0,Total,419,407,12
2011,L18  1,L18  1,Total,2588,2459,129
2011,L18  2,L18  2,Total,820,783,37
2011,L18  3,L18  3,Total,1323,1281,42
2011,L18  4,L18  4,Total,901,880,21
2011,L18  5,L18  5,Total,1092,1052,40
2011,L18  6,L18  6,Total,705,670,35
2011,L18  7,L18  7,Total,1225,1205,20
2011,L18  8,L18  8,Total,1584,1512,72
2011,L18  9,L18  9,Total,1511,1472,39
2011,L19  0,L19  0,Total,1087,1050,37
2011,L19  1,L19  1,Total,1309,1243,66
2011,L19  2,L19  2,Total,1535,1466,69
2011,L19  3,L19  3,Total,1242,1202,40
2011,L19  4,L19  4,Total,1246,1213,33
2011,L19  5,L19  5,Total,755,726,29
2011,L19  6,L19  6,Total,509,495,14
2011,L19  7,L19  7,Total,507,492,15
2011,L19  8,L19  8,Total,1420,1388,32
2011,L19  9,L19  9,Total,1283,1254,29
2011,L2   0,L2   0,Total,141,124,17
2011,L2   2,L2   2,Total,117,110,7
2011,L2   5,L2   5,Total,140,138,2
2011,L20  0,L20  0,Total,1409,1321,88
2011,L20  2,L20  2,Total,1207,1082,125
2011,L20  3,L20  3,Total,1409,1267,142
2011,L20  4,L20  4,Total,3536,3176,360
2011,L20  5,L20  5,Total,1414,1236,178
2011,L20  6,L20  6,Total,2283,2205,78
2011,L20  7,L20  7,Total,1063,946,117
2011,L20  8,L20  8,Total,182,166,16
2011,L20  9,L20  9,Total,2745,2573,172
2011,L21  0,L21  0,Total,1624,1603,21
2011,L21  1,L21  1,Total,1832,1667,165
2011,L21  2,L21  2,Total,525,502,23
2011,L21  3,L21  3,Total,354,249,105
2011,L21  4,L21  4,Total,830,792,38
2011,L21  5,L21  5,Total,794,783,11
2011,L21  6,L21  6,Total,427,399,28
2011,L21  7,L21  7,Total,1534,1501,33
2011,L21  8,L21  8,Total,1692,1564,128
2011,L21  9,L21  9,Total,2100,2071,29
2011,L22  0,L22  0,Total,726,595,131
2011,L22  1,L22  1,Total,498,415,83
2011,L22  2,L22  2,Total,777,763,14
2011,L22  3,L22  3,Total,533,472,61
2011,L22  4,L22  4,Total,851,820,31
2011,L22  5,L22  5,Total,745,656,89
2011,L22  6,L22  6,Total,618,604,14
2011,L22  7,L22  7,Total,579,562,17
2011,L22  8,L22  8,Total,649,600,49
2011,L22  9,L22  9,Total,613,582,31
2011,L23  0,L23  0,Total,1915,1871,44
2011,L23  1,L23  1,Total,996,963,33
2011,L23  2,L23  2,Total,1373,1332,41
2011,L23  3,L23  3,Total,1106,1049,57
2011,L23  4,L23  4,Total,476,460,16
2011,L23  5,L23  5,Total,1057,984,73
2011,L23  6,L23  6,Total,1571,1456,115
2011,L23  7,L23  7,Total,1274,1232,42
2011,L23  8,L23  8,Total,959,911,48
2011,L23  9,L23  9,Total,2457,2398,59
2011,L24  0,L24  0,Total,1270,1248,22
2011,L24  1,L24  1,Total,482,474,8
2011,L24  2,L24  2,Total,1346,1325,21
2011,L24  3,L24  3,Total,1284,1268,16
2011,L24  4,L24  4,Total,413,394,19
2011,L24  5,L24  5,Total,403,393,10
2011,L24  6,L24  6,Total,553,524,29
2011,L24  7,L24  7,Total,839,800,39
2011,L24  9,L24  9,Total,463,435,28
2011,L25  0,L25  0,Total,1355,1328,27
2011,L25  1,L25  1,Total,957,944,13
2011,L25  2,L25  2,Total,1625,1609,16
2011,L25  3,L25  3,Total,1478,1448,30
2011,L25  4,L25  4,Total,1293,1242,51
2011,L25  5,L25  5,Total,2131,2076,55
2011,L25  6,L25  6,Total,739,711,28
2011,L25  7,L25  7,Total,2312,2219,93
2011,L25  8,L25  8,Total,1764,1720,44
2011,L25  9,L25  9,Total,2034,1997,37
2011,L26  0,L26  0,Total,977,958,19
2011,L26  1,L26  1,Total,1451,1403,48
2011,L26  3,L26  3,Total,129,124,5
2011,L26  6,L26  6,Total,513,506,7
2011,L26  7,L26  7,Total,1832,1818,14
2011,L26  9,L26  9,Total,1346,1327,19
2011,L27  0,L27  0,Total,148,147,1
2011,L27  1,L27  1,Total,575,566,9
2011,L27  4,L27  4,Total,111,111,0
2011,L27  5,L27  5,Total,493,481,12
2011,L27  6,L27  6,Total,447,446,1
2011,L27  7,L27  7,Total,566,560,6
2011,L27  8,L27  8,Total,466,464,2
2011,L28  0,L28  0,Total,443,434,9
2011,L28  1,L28  1,Total,662,662,0
2011,L28  3,L28  3,Total,104,103,1
2011,L28  4,L28  4,Total,638,621,17
2011,L28  5,L28  5,Total,596,570,26
2011,L28  6,L28  6,Total,219,214,5
2011,L28  7,L28  7,Total,147,145,2
2011,L28  8,L28  8,Total,228,223,5
2011,L29  7,L29  7,Total,161,152,9
2011,L3   0,L3   0,Total,409,378,31
2011,L3   1,L3   1,Total,663,603,60
2011,L3   2,L3   2,Total,873,841,32
2011,L3   3,L3   3,Total,201,200,1
2011,L3   4,L3   4,Total,1931,1788,143
2011,L3   5,L3   5,Total,750,699,51
2011,L3   6,L3   6,Total,1549,1459,90
2011,L3   8,L3   8,Total,882,810,72
2011,L3   9,L3   9,Total,863,777,86
2011,L30  0,L30  0,Total,972,946,26
2011,L30  1,L30  1,Total,1727,1671,56
2011,L30  2,L30  2,Total,1443,1403,40
2011,L30  3,L30  3,Total,852,826,26
2011,L30  5,L30  5,Total,1423,1367,56
2011,L30  6,L30  6,Total,113,112,1
2011,L30  7,L30  7,Total,1176,1159,17
2011,L30  8,L30  8,Total,571,556,15
2011,L30  9,L30  9,Total,426,411,15
2011,L31  0,L31  0,Total,1098,1058,40
2011,L31  1,L31  1,Total,1622,1569,53
2011,L31  2,L31  2,Total,1432,1386,46
2011,L31  3,L31  3,Total,673,648,25
2011,L31  4,L31  4,Total,955,943,12
2011,L31  5,L31  5,Total,1480,1454,26
2011,L31  6,L31  6,Total,1429,1393,36
2011,L31  7,L31  7,Total,1250,1218,32
2011,L31  8,L31  8,Total,1270,1230,40
2011,L31  9,L31  9,Total,1724,1685,39
2011,L32  0,L32  0,Total,1432,1393,39
2011,L32  1,L32  1,Total,590,577,13
2011,L32  2,L32  2,Total,1000,981,19
2011,L32  3,L32  3,Total,565,553,12
2011,L32  4,L32  4,Total,836,826,10
2011,L32  5,L32  5,Total,346,326,20
2011,L32  6,L32  6,Total,1107,1075,32
2011,L32  7,L32  7,Total,903,883,20
2011,L32  8,L32  8,Total,931,906,25
2011,L32  9,L32  9,Total,1301,1284,17
2011,L33  0,L33  0,Total,494,485,9
2011,L33  1,L33  1,Total,1931,1906,25
2011,L33  2,L33  2,Total,492,486,6
2011,L33  4,L33  4,Total,1470,1452,18
2011,L33  5,L33  5,Total,583,566,17
2011,L33  6,L33  6,Total,606,580,26
2011,L33  7,L33  7,Total,107,102,5
2011,L33  8,L33  8,Total,526,513,13
2011,L33  9,L33  9,Total,738,727,11
2011,L34  0,L34  0,Total,1057,1038,19
2011,L34  1,L34  1,Total,821,796,25
2011,L34  2,L34  2,Total,1438,1398,40
2011,L34  3,L34  3,Total,360,345,15
2011,L34  4,L34  4,Total,160,158,2
2011,L34  5,L34  5,Total,747,691,56
2011,L34  6,L34  6,Total,943,894,49
2011,L35  0,L35  0,Total,1165,1144,21
2011,L35  1,L35  1,Total,596,583,13
2011,L35  2,L35  2,Total,976,948,28
2011,L35  3,L35  3,Total,3303,3196,107
2011,L35  4,L35  4,Total,1277,1229,48
2011,L35  5,L35  5,Total,2287,2138,149
2011,L35  6,L35  6,Total,579,570,9
2011,L35  7,L35  7,Total,1111,1088,23
2011,L35  8,L35  8,Total,1377,1266,111
2011,L35  9,L35  9,Total,685,663,22
2011,L36  0,L36  0,Total,1922,1871,51
2011,L36  1,L36  1,Total,1270,1230,40
2011,L36  2,L36  2,Total,2170,2112,58
2011,L36  3,L36  3,Total,2001,1969,32
2011,L36  4,L36  4,Total,2729,2632,97
2011,L36  5,L36  5,Total,1824,1764,60
2011,L36  6,L36  6,Total,1093,1061,32
2011,L36  7,L36  7,Total,1631,1580,51
2011,L36  8,L36  8,Total,1897,1874,23
2011,L36  9,L36  9,Total,662,637,25
2011,L37  1,L37  1,Total,976,960,16
2011,L37  2,L37  2,Total,2029,1991,38
2011,L37  3,L37  3,Total,2261,2151,110
2011,L37  4,L37  4,Total,1145,1117,28
2011,L37  5,L37  5,Total,95,93,2
2011,L37  6,L37  6,Total,1240,1210,30
2011,L37  7,L37  7,Total,1529,1480,49
2011,L37  8,L37  8,Total,868,853,15
2011,L38  0,L38  0,Total,254,248,6
2011,L38  1,L38  1,Total,121,113,8
2011,L38  3,L38  3,Total,126,126,0
2011,L38  6,L38  6,Total,101,98,3
2011,L38  9,L38  9,Total,523,518,5
2011,L39  0,L39  0,Total,529,495,34
2011,L39  1,L39  1,Total,2167,2082,85
2011,L39  2,L39  2,Total,1380,1290,90
2011,L39  3,L39  3,Total,1429,1376,53
2011,L39  4,L39  4,Total,2464,2367,97
2011,L39  5,L39  5,Total,1965,1888,77
2011,L39  6,L39  6,Total,921,890,31
2011,L39  7,L39  7,Total,482,450,32
2011,L39  8,L39  8,Total,595,557,38
2011,L4   0,L4   0,Total,1599,1454,145
2011,L4   1,L4   1,Total,1645,1550,95
2011,L4   2,L4   2,Total,2618,2496,122
2011,L4   3,L4   3,Total,1711,1639,72
2011,L4   4,L4   4,Total,2263,2137,126
2011,L4   5,L4   5,Total,3259,3026,233
2011,L4   6,L4   6,Total,1364,1311,53
2011,L4   7,L4   7,Total,1606,1567,39
2011,L4   8,L4   8,Total,1137,1118,19
2011,L4   9,L4   9,Total,2385,2349,36
2011,L40  0,L40  0,Total,603,554,49
2011,L40  1,L40  1,Total,863,822,41
2011,L40  2,L40  2,Total,458,439,19
2011,L40  3,L40  3,Total,531,502,29
2011,L40  4,L40  4,Total,710,680,30
2011,L40  5,L40  5,Total,1167,1111,56
2011,L40  6,L40  6,Total,467,450,17
2011,L40  7,L40  7,Total,1992,1928,64
2011,L40  8,L40  8,Total,575,409,166
2011,L40  9,L40  9,Total,569,539,30
2011,L5   0,L5   0,Total,896,894,2
2011,L5   1,L5   1,Total,266,258,8
2011,L5   2,L5   2,Total,399,391,8
2011,L5   3,L5   3,Total,992,954,38
2011,L5   4,L5   4,Total,612,600,12
2011,L5   5,L5   5,Total,477,459,18
2011,L5   6,L5   6,Total,1177,1116,61
2011,L5   7,L5   7,Total,715,658,57
2011,L5   8,L5   8,Total,396,385,11
2011,L5   9,L5   9,Total,514,491,23
2011,L6   0,L6   0,Total,1325,1243,82
2011,L6   1,L6   1,Total,891,857,34
2011,L6   2,L6   2,Total,1127,1118,9
2011,L6   3,L6   3,Total,1314,1202,112
2011,L6   4,L6   4,Total,1850,1717,133
2011,L6   5,L6   5,Total,1433,1392,41
2011,L6   6,L6   6,Total,1771,1626,145
2011,L6   7,L6   7,Total,422,393,29
2011,L6   8,L6   8,Total,913,883,30
2011,L6   9,L6   9,Total,649,618,31
2011,L7   0,L7   0,Total,1751,1642,109
2011,L7   1,L7   1,Total,135,126,9
2011,L7   2,L7   2,Total,882,815,67
2011,L7   3,L7   3,Total,1018,994,24
2011,L7   4,L7   4,Total,241,218,23
2011,L7   5,L7   5,Total,578,564,14
2011,L7   6,L7   6,Total,869,839,30
2011,L7   7,L7   7,Total,749,708,41
2011,L7   8,L7   8,Total,1516,1464,52
2011,L7   9,L7   9,Total,153,148,5
2011,L8   0,L8   0,Total,3703,3487,216
2011,L8   1,L8   1,Total,619,592,27
2011,L8   2,L8   2,Total,1077,805,272
2011,L8   3,L8   3,Total,1662,1531,131
2011,L8   4,L8   4,Total,2020,1951,69
2011,L8   5,L8   5,Total,954,906,48
2011,L8   6,L8   6,Total,1143,1086,57
2011,L8   7,L8   7,Total,2946,2685,261
2011,L8   8,L8   8,Total,2338,1949,389
2011,L8   9,L8   9,Total,1256,1209,47
2011,L9   0,L9   0,Total,1819,1761,58
2011,L9   1,L9   1,Total,3207,3097,110
2011,L9   2,L9   2,Total,1157,1133,24
2011,L9   3,L9   3,Total,1165,1131,34
2011,L9   4,L9   4,Total,416,400,16
2011,L9   6,L9   6,Total,1712,1664,48
2011,L9   7,L9   7,Total,365,361,4
2011,L9   8,L9   8,Total,1965,1915,50
2011,L9   9,L9   9,Total,2259,2143,116
2011,LA1  1,LA1  1,Total,2682,2467,215
2011,LA1  2,LA1  2,Total,4949,4791,158
2011,LA1  3,LA1  3,Total,4184,4031,153
2011,LA1  4,LA1  4,Total,5432,5281,151
2011,LA1  5,LA1  5,Total,4095,3967,128
2011,LA10 5,LA10 5,Total,1998,1668,330
2011,LA11 6,LA11 6,Total,2176,1806,370
2011,LA11 7,LA11 7,Total,3148,2771,377
2011,LA12 0,LA12 0,Total,2867,2701,166
2011,LA12 7,LA12 7,Total,2460,2156,304
2011,LA12 8,LA12 8,Total,1558,1132,426
2011,LA12 9,LA12 9,Total,3317,3170,147
2011,LA13 0,LA13 0,Total,3891,3738,153
2011,LA13 9,LA13 9,Total,4486,4303,183
2011,LA14 1,LA14 1,Total,1905,1756,149
2011,LA14 2,LA14 2,Total,4095,3620,475
2011,LA14 3,LA14 3,Total,5056,4860,196
2011,LA14 4,LA14 4,Total,3138,3009,129
2011,LA14 5,LA14 5,Total,5139,4889,250
2011,LA15 8,LA15 8,Total,3633,3436,197
2011,LA16 7,LA16 7,Total,1521,1427,94
2011,LA17 7,LA17 7,Total,605,530,75
2011,LA18 4,LA18 4,Total,2538,2313,225
2011,LA18 5,LA18 5,Total,1568,1420,148
2011,LA19 5,LA19 5,Total,475,427,48
2011,LA2  0,LA2  0,Total,1627,1558,69
2011,LA2  6,LA2  6,Total,2450,2332,118
2011,LA2  7,LA2  7,Total,1508,1366,142
2011,LA2  8,LA2  8,Total,1598,1450,148
2011,LA2  9,LA2  9,Total,2027,1929,98
2011,LA20 6,LA20 6,Total,702,526,176
2011,LA21 8,LA21 8,Total,635,419,216
2011,LA22 0,LA22 0,Total,1704,1052,652
2011,LA22 9,LA22 9,Total,1874,1173,701
2011,LA23 1,LA23 1,Total,1677,1264,413
2011,LA23 2,LA23 2,Total,2020,1764,256
2011,LA23 3,LA23 3,Total,1590,1037,553
2011,LA3  1,LA3  1,Total,4245,3800,445
2011,LA3  2,LA3  2,Total,4534,4374,160
2011,LA3  3,LA3  3,Total,2609,2500,109
2011,LA4  4,LA4  4,Total,4503,4202,301
2011,LA4  5,LA4  5,Total,4352,4102,250
2011,LA4  6,LA4  6,Total,4111,3930,181
2011,LA5  0,LA5  0,Total,2105,1838,267
2011,LA5  8,LA5  8,Total,1881,1812,69
2011,LA5  9,LA5  9,Total,3849,3683,166
2011,LA6  1,LA6  1,Total,2454,2255,199
2011,LA6  2,LA6  2,Total,2141,1858,283
2011,LA6  3,LA6  3,Total,1579,1359,220
2011,LA7  7,LA7  7,Total,2451,2283,168
2011,LA8  0,LA8  0,Total,1307,1235,72
2011,LA8  8,LA8  8,Total,1412,1219,193
2011,LA8  9,LA8  9,Total,1743,1460,283
2011,LA9  4,LA9  4,Total,2372,2151,221
2011,LA9  5,LA9  5,Total,4187,4071,116
2011,LA9  6,LA9  6,Total,3169,3065,104
2011,LA9  7,LA9  7,Total,4557,4394,163
2011,LE1  1,LE1  1,Total,1186,1097,89
2011,LE1  2,LE1  2,Total,1430,1425,5
2011,LE1  3,LE1  3,Total,462,400,62
2011,LE1  4,LE1  4,Total,436,397,39
2011,LE1  5,LE1  5,Total,719,688,31
2011,LE1  6,LE1  6,Total,1447,1377,70
2011,LE1  7,LE1  7,Total,281,251,30
2011,LE10 0,LE10 0,Total,9146,8857,289
2011,LE10 1,LE10 1,Total,4781,4599,182
2011,LE10 2,LE10 2,Total,6587,6393,194
2011,LE10 3,LE10 3,Total,990,968,22
2011,LE11 1,LE11 1,Total,4739,4338,401
2011,LE11 2,LE11 2,Total,5815,5599,216
2011,LE11 3,LE11 3,Total,4355,4168,187
2011,LE11 4,LE11 4,Total,4144,4013,131
2011,LE11 5,LE11 5,Total,4577,4241,336
2011,LE12 5,LE12 5,Total,3051,2924,127
2011,LE12 6,LE12 6,Total,3874,3766,108
2011,LE12 7,LE12 7,Total,7221,7022,199
2011,LE12 8,LE12 8,Total,6082,5862,220
2011,LE12 9,LE12 9,Total,6601,6357,244
2011,LE13 0,LE13 0,Total,6595,6387,208
2011,LE13 1,LE13 1,Total,5370,5226,144
2011,LE14 2,LE14 2,Total,2042,1937,105
2011,LE14 3,LE14 3,Total,2927,2835,92
2011,LE14 4,LE14 4,Total,2659,2569,90
2011,LE15 6,LE15 6,Total,4851,4690,161
2011,LE15 7,LE15 7,Total,3385,2998,387
2011,LE15 8,LE15 8,Total,2756,2564,192
2011,LE15 9,LE15 9,Total,2884,2658,226
2011,LE16 7,LE16 7,Total,4758,4606,152
2011,LE16 8,LE16 8,Total,4799,4433,366
2011,LE16 9,LE16 9,Total,5685,5487,198
2011,LE17 4,LE17 4,Total,4552,4422,130
2011,LE17 5,LE17 5,Total,2524,2458,66
2011,LE17 6,LE17 6,Total,1622,1570,52
2011,LE18 1,LE18 1,Total,3271,3141,130
2011,LE18 2,LE18 2,Total,3726,3536,190
2011,LE18 3,LE18 3,Total,3566,3431,135
2011,LE18 4,LE18 4,Total,3528,3321,207
2011,LE19 2,LE19 2,Total,2601,2524,77
2011,LE19 3,LE19 3,Total,1913,1875,38
2011,LE19 4,LE19 4,Total,1822,1781,41
2011,LE2  0,LE2  0,Total,4638,4394,244
2011,LE2  1,LE2  1,Total,5156,4948,208
2011,LE2  2,LE2  2,Total,2427,2306,121
2011,LE2  3,LE2  3,Total,4780,4609,171
2011,LE2  4,LE2  4,Total,4498,4267,231
2011,LE2  5,LE2  5,Total,3689,3451,238
2011,LE2  6,LE2  6,Total,5723,5548,175
2011,LE2  7,LE2  7,Total,3492,3327,165
2011,LE2  8,LE2  8,Total,4981,4778,203
2011,LE2  9,LE2  9,Total,6575,6450,125
2011,LE3  0,LE3  0,Total,5058,4756,302
2011,LE3  1,LE3  1,Total,6044,5927,117
2011,LE3  2,LE3  2,Total,6130,5922,208
2011,LE3  3,LE3  3,Total,5483,5334,149
2011,LE3  5,LE3  5,Total,3193,2988,205
2011,LE3  6,LE3  6,Total,5671,5527,144
2011,LE3  8,LE3  8,Total,4496,4369,127
2011,LE3  9,LE3  9,Total,6583,6403,180
2011,LE4  0,LE4  0,Total,6090,5966,124
2011,LE4  1,LE4  1,Total,2024,1962,62
2011,LE4  2,LE4  2,Total,4232,4146,86
2011,LE4  3,LE4  3,Total,2254,2178,76
2011,LE4  4,LE4  4,Total,2826,2745,81
2011,LE4  5,LE4  5,Total,3354,3209,145
2011,LE4  6,LE4  6,Total,5215,5069,146
2011,LE4  7,LE4  7,Total,4221,4104,117
2011,LE4  8,LE4  8,Total,4071,3944,127
2011,LE4  9,LE4  9,Total,3126,3082,44
2011,LE5  0,LE5  0,Total,2931,2849,82
2011,LE5  1,LE5  1,Total,6212,6091,121
2011,LE5  2,LE5  2,Total,4309,4189,120
2011,LE5  3,LE5  3,Total,3007,2899,108
2011,LE5  4,LE5  4,Total,4938,4796,142
2011,LE5  5,LE5  5,Total,4997,4869,128
2011,LE5  6,LE5  6,Total,3349,3221,128
2011,LE6  0,LE6  0,Total,5184,5049,135
2011,LE65 1,LE65 1,Total,2687,2588,99
2011,LE65 2,LE65 2,Total,3396,3287,109
2011,LE67 1,LE67 1,Total,2291,2196,95
2011,LE67 2,LE67 2,Total,3275,3166,109
2011,LE67 3,LE67 3,Total,3934,3756,178
2011,LE67 4,LE67 4,Total,4400,4267,133
2011,LE67 5,LE67 5,Total,3779,3679,100
2011,LE67 6,LE67 6,Total,2556,2485,71
2011,LE67 8,LE67 8,Total,2529,2476,53
2011,LE67 9,LE67 9,Total,2740,2662,78
2011,LE7  1,LE7  1,Total,2596,2502,94
2011,LE7  2,LE7  2,Total,3015,2903,112
2011,LE7  3,LE7  3,Total,2238,2192,46
2011,LE7  4,LE7  4,Total,1601,1561,40
2011,LE7  7,LE7  7,Total,5512,5306,206
2011,LE7  9,LE7  9,Total,4299,4138,161
2011,LE8  0,LE8  0,Total,2744,2645,99
2011,LE8  4,LE8  4,Total,2743,2687,56
2011,LE8  5,LE8  5,Total,2985,2914,71
2011,LE8  6,LE8  6,Total,2791,2746,45
2011,LE8  8,LE8  8,Total,1982,1948,34
2011,LE8  9,LE8  9,Total,1653,1614,39
2011,LE9  1,LE9  1,Total,1475,1446,29
2011,LE9  2,LE9  2,Total,2020,1967,53
2011,LE9  3,LE9  3,Total,1442,1405,37
2011,LE9  4,LE9  4,Total,2735,2649,86
2011,LE9  6,LE9  6,Total,3474,3422,52
2011,LE9  7,LE9  7,Total,5467,5220,247
2011,LE9  8,LE9  8,Total,4230,4062,168
2011,LE9  9,LE9  9,Total,3020,2938,82
2011,LN1  1,LN1  1,Total,3500,3205,295
2011,LN1  2,LN1  2,Total,5072,4966,106
2011,LN1  3,LN1  3,Total,4432,4087,345
2011,LN10 5,LN10 5,Total,395,365,30
2011,LN10 6,LN10 6,Total,2487,2333,154
2011,LN11 0,LN11 0,Total,4580,4400,180
2011,LN11 7,LN11 7,Total,2361,2215,146
2011,LN11 8,LN11 8,Total,3638,3537,101
2011,LN11 9,LN11 9,Total,2598,2457,141
2011,LN12 1,LN12 1,Total,2573,2339,234
2011,LN12 2,LN12 2,Total,4481,4010,471
2011,LN13 0,LN13 0,Total,1225,1152,73
2011,LN13 9,LN13 9,Total,2382,2213,169
2011,LN2  1,LN2  1,Total,896,785,111
2011,LN2  2,LN2  2,Total,4686,4546,140
2011,LN2  3,LN2  3,Total,2771,2707,64
2011,LN2  4,LN2  4,Total,5658,5423,235
2011,LN2  5,LN2  5,Total,3296,2952,344
2011,LN3  4,LN3  4,Total,2593,2528,65
2011,LN3  5,LN3  5,Total,1405,1320,85
2011,LN4  1,LN4  1,Total,4787,4660,127
2011,LN4  2,LN4  2,Total,3678,3562,116
2011,LN4  3,LN4  3,Total,3673,3511,162
2011,LN4  4,LN4  4,Total,4785,4450,335
2011,LN5  0,LN5  0,Total,2581,2480,101
2011,LN5  7,LN5  7,Total,3164,2711,453
2011,LN5  8,LN5  8,Total,4234,3932,302
2011,LN5  9,LN5  9,Total,5013,4855,158
2011,LN6  0,LN6  0,Total,6207,5988,219
2011,LN6  3,LN6  3,Total,1861,1780,81
2011,LN6  4,LN6  4,Total,120,117,3
2011,LN6  5,LN6  5,Total,1394,1373,21
2011,LN6  7,LN6  7,Total,5243,4977,266
2011,LN6  8,LN6  8,Total,4422,4289,133
2011,LN6  9,LN6  9,Total,5765,5600,165
2011,LN7  6,LN7  6,Total,2746,2622,124
2011,LN8  2,LN8  2,Total,810,766,44
2011,LN8  3,LN8  3,Total,4433,4202,231
2011,LN8  5,LN8  5,Total,1421,1359,62
2011,LN8  6,LN8  6,Total,1305,1235,70
2011,LN9  5,LN9  5,Total,2238,2110,128
2011,LN9  6,LN9  6,Total,2450,2326,124
2011,LS1  2,LS1  2,Total,136,79,57
2011,LS1  3,LS1  3,Total,272,253,19
2011,LS1  4,LS1  4,Total,1570,1353,217
2011,LS1  5,LS1  5,Total,155,140,15
2011,LS1  6,LS1  6,Total,256,237,19
2011,LS10 1,LS10 1,Total,2256,2102,154
2011,LS10 2,LS10 2,Total,1918,1829,89
2011,LS10 3,LS10 3,Total,5702,5539,163
2011,LS10 4,LS10 4,Total,6570,6402,168
2011,LS11 0,LS11 0,Total,1992,1818,174
2011,LS11 5,LS11 5,Total,2769,2608,161
2011,LS11 6,LS11 6,Total,3036,2725,311
2011,LS11 7,LS11 7,Total,3807,3539,268
2011,LS11 8,LS11 8,Total,3595,3372,223
2011,LS11 9,LS11 9,Total,1655,1499,156
2011,LS12 1,LS12 1,Total,3016,2859,157
2011,LS12 2,LS12 2,Total,2594,2506,88
2011,LS12 3,LS12 3,Total,4366,4090,276
2011,LS12 4,LS12 4,Total,4303,4153,150
2011,LS12 5,LS12 5,Total,4317,4192,125
2011,LS12 6,LS12 6,Total,694,661,33
2011,LS13 1,LS13 1,Total,3457,3358,99
2011,LS13 2,LS13 2,Total,4689,4612,77
2011,LS13 3,LS13 3,Total,3310,3255,55
2011,LS13 4,LS13 4,Total,4512,4434,78
2011,LS14 1,LS14 1,Total,3524,3380,144
2011,LS14 2,LS14 2,Total,1981,1956,25
2011,LS14 3,LS14 3,Total,1362,1306,56
2011,LS14 5,LS14 5,Total,3305,3224,81
2011,LS14 6,LS14 6,Total,5335,5164,171
2011,LS15 0,LS15 0,Total,3483,3376,107
2011,LS15 4,LS15 4,Total,2362,2295,67
2011,LS15 7,LS15 7,Total,4053,3920,133
2011,LS15 8,LS15 8,Total,4134,4004,130
2011,LS15 9,LS15 9,Total,1637,1620,17
2011,LS16 5,LS16 5,Total,3415,3263,152
2011,LS16 6,LS16 6,Total,4353,4223,130
2011,LS16 7,LS16 7,Total,5003,4890,113
2011,LS16 8,LS16 8,Total,1659,1616,43
2011,LS16 9,LS16 9,Total,1639,1589,50
2011,LS17 0,LS17 0,Total,599,571,28
2011,LS17 5,LS17 5,Total,3141,3059,82
2011,LS17 6,LS17 6,Total,4528,4386,142
2011,LS17 7,LS17 7,Total,4091,3945,146
2011,LS17 8,LS17 8,Total,4896,4758,138
2011,LS17 9,LS17 9,Total,1987,1911,76
2011,LS18 4,LS18 4,Total,4305,4192,113
2011,LS18 5,LS18 5,Total,4301,4163,138
2011,LS19 6,LS19 6,Total,2709,2611,98
2011,LS19 7,LS19 7,Total,6209,6048,161
2011,LS2  7,LS2  7,Total,1714,1496,218
2011,LS2  8,LS2  8,Total,361,328,33
2011,LS2  9,LS2  9,Total,1455,1367,88
2011,LS20 8,LS20 8,Total,2938,2864,74
2011,LS20 9,LS20 9,Total,2579,2480,99
2011,LS21 1,LS21 1,Total,2612,2532,80
2011,LS21 2,LS21 2,Total,3105,3028,77
2011,LS21 3,LS21 3,Total,2404,2304,100
2011,LS22 4,LS22 4,Total,843,802,41
2011,LS22 5,LS22 5,Total,1564,1518,46
2011,LS22 6,LS22 6,Total,2819,2723,96
2011,LS22 7,LS22 7,Total,1859,1825,34
2011,LS23 6,LS23 6,Total,3420,3294,126
2011,LS23 7,LS23 7,Total,434,420,14
2011,LS24 8,LS24 8,Total,1451,1388,63
2011,LS24 9,LS24 9,Total,3776,3580,196
2011,LS25 1,LS25 1,Total,3457,3360,97
2011,LS25 2,LS25 2,Total,2963,2932,31
2011,LS25 3,LS25 3,Total,658,639,19
2011,LS25 4,LS25 4,Total,833,820,13
2011,LS25 5,LS25 5,Total,2063,1953,110
2011,LS25 6,LS25 6,Total,2897,2779,118
2011,LS25 7,LS25 7,Total,4373,4272,101
2011,LS26 0,LS26 0,Total,6168,6042,126
2011,LS26 8,LS26 8,Total,5192,5092,100
2011,LS26 9,LS26 9,Total,1708,1654,54
2011,LS27 0,LS27 0,Total,3190,3066,124
2011,LS27 7,LS27 7,Total,4642,4526,116
2011,LS27 8,LS27 8,Total,4835,4664,171
2011,LS27 9,LS27 9,Total,4008,3918,90
2011,LS28 5,LS28 5,Total,5199,5068,131
2011,LS28 6,LS28 6,Total,1604,1530,74
2011,LS28 7,LS28 7,Total,4205,4101,104
2011,LS28 8,LS28 8,Total,3380,3257,123
2011,LS28 9,LS28 9,Total,2760,2683,77
2011,LS29 0,LS29 0,Total,2363,2271,92
2011,LS29 6,LS29 6,Total,2414,2307,107
2011,LS29 7,LS29 7,Total,3080,3000,80
2011,LS29 8,LS29 8,Total,3655,3493,162
2011,LS29 9,LS29 9,Total,2678,2523,155
2011,LS3  1,LS3  1,Total,1144,1077,67
2011,LS4  2,LS4  2,Total,3996,3868,128
2011,LS5  3,LS5  3,Total,3499,3368,131
2011,LS6  1,LS6  1,Total,5297,5062,235
2011,LS6  2,LS6  2,Total,3657,3506,151
2011,LS6  3,LS6  3,Total,4332,4147,185
2011,LS6  4,LS6  4,Total,4375,4228,147
2011,LS7  1,LS7  1,Total,2007,1949,58
2011,LS7  2,LS7  2,Total,3318,3213,105
2011,LS7  3,LS7  3,Total,3974,3797,177
2011,LS7  4,LS7  4,Total,3944,3778,166
2011,LS8  1,LS8  1,Total,4286,4130,156
2011,LS8  2,LS8  2,Total,4855,4629,226
2011,LS8  3,LS8  3,Total,4559,4392,167
2011,LS8  4,LS8  4,Total,2360,2198,162
2011,LS8  5,LS8  5,Total,3369,3145,224
2011,LS9  0,LS9  0,Total,2719,2610,109
2011,LS9  6,LS9  6,Total,5500,5277,223
2011,LS9  7,LS9  7,Total,3854,3789,65
2011,LS9  8,LS9  8,Total,2840,2722,118
2011,LS9  9,LS9  9,Total,2727,2616,111
2011,LU1  1,LU1  1,Total,4827,4604,223
2011,LU1  2,LU1  2,Total,565,484,81
2011,LU1  3,LU1  3,Total,4237,4114,123
2011,LU1  4,LU1  4,Total,2518,2414,104
2011,LU1  5,LU1  5,Total,4781,4663,118
2011,LU2  0,LU2  0,Total,4718,4599,119
2011,LU2  7,LU2  7,Total,8487,8300,187
2011,LU2  8,LU2  8,Total,5305,5228,77
2011,LU2  9,LU2  9,Total,4646,4580,66
2011,LU3  1,LU3  1,Total,6700,6527,173
2011,LU3  2,LU3  2,Total,5549,5425,124
2011,LU3  3,LU3  3,Total,7613,7359,254
2011,LU3  4,LU3  4,Total,2334,2270,64
2011,LU4  0,LU4  0,Total,6728,6545,183
2011,LU4  8,LU4  8,Total,4408,4291,117
2011,LU4  9,LU4  9,Total,7117,6953,164
2011,LU5  4,LU5  4,Total,5853,5597,256
2011,LU5  5,LU5  5,Total,7031,6812,219
2011,LU5  6,LU5  6,Total,3143,3049,94
2011,LU6  1,LU6  1,Total,4828,4597,231
2011,LU6  2,LU6  2,Total,3531,3393,138
2011,LU6  3,LU6  3,Total,5063,4921,142
2011,LU7  0,LU7  0,Total,3883,3698,185
2011,LU7  1,LU7  1,Total,2785,2587,198
2011,LU7  2,LU7  2,Total,4997,4854,143
2011,LU7  3,LU7  3,Total,5572,5269,303
2011,LU7  4,LU7  4,Total,3062,2971,91
2011,LU7  9,LU7  9,Total,3177,2983,194
2011,M1   1,M1   1,Total,472,447,25
2011,M1   2,M1   2,Total,1157,1095,62
2011,M1   3,M1   3,Total,727,684,43
2011,M1   4,M1   4,Total,137,122,15
2011,M1   5,M1   5,Total,1472,1346,126
2011,M1   6,M1   6,Total,574,538,36
2011,M1   7,M1   7,Total,1001,965,36
2011,M11  1,M11  1,Total,2463,2328,135
2011,M11  2,M11  2,Total,1443,1362,81
2011,M11  3,M11  3,Total,1500,1463,37
2011,M11  4,M11  4,Total,3681,3526,155
2011,M12  4,M12  4,Total,2678,2599,79
2011,M12  5,M12  5,Total,3514,3293,221
2011,M12  6,M12  6,Total,317,309,8
2011,M13  0,M13  0,Total,4907,4636,271
2011,M13  9,M13  9,Total,2418,2333,85
2011,M14  4,M14  4,Total,3535,3336,199
2011,M14  5,M14  5,Total,3803,3427,376
2011,M14  6,M14  6,Total,5966,5586,380
2011,M14  7,M14  7,Total,5241,5015,226
2011,M15  4,M15  4,Total,5038,4783,255
2011,M15  5,M15  5,Total,3160,3041,119
2011,M15  6,M15  6,Total,1951,1880,71
2011,M16  0,M16  0,Total,2982,2896,86
2011,M16  7,M16  7,Total,3132,3057,75
2011,M16  8,M16  8,Total,4992,4606,386
2011,M16  9,M16  9,Total,3280,3192,88
2011,M18  7,M18  7,Total,5369,5140,229
2011,M18  8,M18  8,Total,4859,4618,241
2011,M19  1,M19  1,Total,4681,4550,131
2011,M19  2,M19  2,Total,5258,4956,302
2011,M19  3,M19  3,Total,4116,3871,245
2011,M20  1,M20  1,Total,3407,3297,110
2011,M20  2,M20  2,Total,5814,5580,234
2011,M20  3,M20  3,Total,2671,2499,172
2011,M20  4,M20  4,Total,4049,3863,186
2011,M20  5,M20  5,Total,1853,1784,69
2011,M20  6,M20  6,Total,3785,3644,141
2011,M21  0,M21  0,Total,2439,2262,177
2011,M21  7,M21  7,Total,3567,3509,58
2011,M21  8,M21  8,Total,2581,2496,85
2011,M21  9,M21  9,Total,4358,4177,181
2011,M22  0,M22  0,Total,1447,1413,34
2011,M22  1,M22  1,Total,3479,3399,80
2011,M22  4,M22  4,Total,4876,4731,145
2011,M22  5,M22  5,Total,3017,2944,73
2011,M22  8,M22  8,Total,1866,1842,24
2011,M22  9,M22  9,Total,4026,3955,71
2011,M23  0,M23  0,Total,3915,3837,78
2011,M23  1,M23  1,Total,3685,3594,91
2011,M23  2,M23  2,Total,2609,2548,61
2011,M23  9,M23  9,Total,3804,3737,67
2011,M24  1,M24  1,Total,5001,4850,151
2011,M24  2,M24  2,Total,5720,5563,157
2011,M24  4,M24  4,Total,4466,4292,174
2011,M24  5,M24  5,Total,3885,3788,97
2011,M24  6,M24  6,Total,2379,2325,54
2011,M25  0,M25  0,Total,2955,2814,141
2011,M25  1,M25  1,Total,3775,3650,125
2011,M25  2,M25  2,Total,1530,1494,36
2011,M25  3,M25  3,Total,1540,1496,44
2011,M25  9,M25  9,Total,3321,3212,109
2011,M26  1,M26  1,Total,4777,4520,257
2011,M26  2,M26  2,Total,2791,2663,128
2011,M26  3,M26  3,Total,4615,4392,223
2011,M26  4,M26  4,Total,3601,3471,130
2011,M27  0,M27  0,Total,3082,2978,104
2011,M27  4,M27  4,Total,2421,2310,111
2011,M27  5,M27  5,Total,3700,3575,125
2011,M27  6,M27  6,Total,2767,2644,123
2011,M27  8,M27  8,Total,3956,3812,144
2011,M27  9,M27  9,Total,2813,2701,112
2011,M28  0,M28  0,Total,2542,2475,67
2011,M28  1,M28  1,Total,4272,4160,112
2011,M28  2,M28  2,Total,2657,2540,117
2011,M28  3,M28  3,Total,5209,5024,185
2011,M28  7,M28  7,Total,3005,2938,67
2011,M29  7,M29  7,Total,5549,5428,121
2011,M29  8,M29  8,Total,4480,4240,240
2011,M3   1,M3   1,Total,368,314,54
2011,M3   2,M3   2,Total,120,98,22
2011,M3   3,M3   3,Total,400,343,57
2011,M3   4,M3   4,Total,1598,1412,186
2011,M3   5,M3   5,Total,900,804,96
2011,M3   6,M3   6,Total,1794,1682,112
2011,M3   7,M3   7,Total,2049,1929,120
2011,M30  0,M30  0,Total,5001,4797,204
2011,M30  7,M30  7,Total,4225,3946,279
2011,M30  8,M30  8,Total,4282,4057,225
2011,M30  9,M30  9,Total,3907,3669,238
2011,M31  4,M31  4,Total,3625,3544,81
2011,M32  0,M32  0,Total,4649,4491,158
2011,M32  8,M32  8,Total,3064,2956,108
2011,M32  9,M32  9,Total,4839,4706,133
2011,M33  2,M33  2,Total,5704,5537,167
2011,M33  3,M33  3,Total,5542,5358,184
2011,M33  4,M33  4,Total,5961,5823,138
2011,M33  5,M33  5,Total,4286,4196,90
2011,M33  6,M33  6,Total,3047,2952,95
2011,M33  7,M33  7,Total,2213,2149,64
2011,M34  2,M34  2,Total,4622,4469,153
2011,M34  3,M34  3,Total,4144,3981,163
2011,M34  5,M34  5,Total,5266,5062,204
2011,M34  6,M34  6,Total,3149,3057,92
2011,M34  7,M34  7,Total,3970,3875,95
2011,M35  0,M35  0,Total,5191,4978,213
2011,M35  9,M35  9,Total,4180,4025,155
2011,M38  0,M38  0,Total,1103,1074,29
2011,M38  9,M38  9,Total,4678,4509,169
2011,M4   1,M4   1,Total,1151,1087,64
2011,M4   4,M4   4,Total,2030,1889,141
2011,M4   5,M4   5,Total,995,950,45
2011,M4   6,M4   6,Total,802,741,61
2011,M4   7,M4   7,Total,1587,1451,136
2011,M40  0,M40  0,Total,1808,1767,41
2011,M40  1,M40  1,Total,2663,2550,113
2011,M40  2,M40  2,Total,2679,2576,103
2011,M40  3,M40  3,Total,3183,3093,90
2011,M40  5,M40  5,Total,1799,1733,66
2011,M40  7,M40  7,Total,2753,2602,151
2011,M40  8,M40  8,Total,1815,1766,49
2011,M40  9,M40  9,Total,2163,2007,156
2011,M41  0,M41  0,Total,2398,2358,40
2011,M41  5,M41  5,Total,2689,2631,58
2011,M41  6,M41  6,Total,3431,3356,75
2011,M41  7,M41  7,Total,2405,2359,46
2011,M41  8,M41  8,Total,2826,2740,86
2011,M41  9,M41  9,Total,3974,3898,76
2011,M43  6,M43  6,Total,4586,4297,289
2011,M43  7,M43  7,Total,5954,5726,228
2011,M44  5,M44  5,Total,3351,3193,158
2011,M44  6,M44  6,Total,5271,5106,165
2011,M45  6,M45  6,Total,2386,2284,102
2011,M45  7,M45  7,Total,4295,3986,309
2011,M45  8,M45  8,Total,3568,3457,111
2011,M46  0,M46  0,Total,4937,4680,257
2011,M46  9,M46  9,Total,5433,5262,171
2011,M5   3,M5   3,Total,2666,2531,135
2011,M5   4,M5   4,Total,3077,2849,228
2011,M5   5,M5   5,Total,2310,2192,118
2011,M50  1,M50  1,Total,725,514,211
2011,M50  2,M50  2,Total,191,168,23
2011,M50  3,M50  3,Total,1841,1480,361
2011,M6   5,M6   5,Total,4520,4271,249
2011,M6   6,M6   6,Total,2005,1888,117
2011,M6   7,M6   7,Total,4042,3875,167
2011,M6   8,M6   8,Total,4288,4097,191
2011,M60  7,M60  7,Total,52,49,3
2011,M60  9,M60  9,Total,102,100,2
2011,M7   1,M7   1,Total,1771,1717,54
2011,M7   2,M7   2,Total,2431,2203,228
2011,M7   3,M7   3,Total,2441,2311,130
2011,M7   4,M7   4,Total,5129,4879,250
2011,M8   0,M8   0,Total,3372,3244,128
2011,M8   4,M8   4,Total,3351,3235,116
2011,M8   5,M8   5,Total,2472,2351,121
2011,M8   8,M8   8,Total,1419,1368,51
2011,M8   9,M8   9,Total,1269,1199,70
2011,M9   0,M9   0,Total,2103,2075,28
2011,M9   4,M9   4,Total,3652,3458,194
2011,M9   5,M9   5,Total,1766,1707,59
2011,M9   6,M9   6,Total,3922,3803,119
2011,M9   7,M9   7,Total,2841,2784,57
2011,M9   8,M9   8,Total,3827,3680,147
2011,ME1  1,ME1  1,Total,2881,2721,160
2011,ME1  2,ME1  2,Total,5936,5803,133
2011,ME1  3,ME1  3,Total,4477,4328,149
2011,ME10 1,ME10 1,Total,5847,5682,165
2011,ME10 2,ME10 2,Total,5785,5664,121
2011,ME10 3,ME10 3,Total,3266,3099,167
2011,ME10 4,ME10 4,Total,3986,3858,128
2011,ME10 5,ME10 5,Total,1043,1011,32
2011,ME11 5,ME11 5,Total,1503,1432,71
2011,ME12 1,ME12 1,Total,2985,2839,146
2011,ME12 2,ME12 2,Total,5527,5258,269
2011,ME12 3,ME12 3,Total,4783,4612,171
2011,ME12 4,ME12 4,Total,2624,2222,402
2011,ME13 0,ME13 0,Total,1545,1453,92
2011,ME13 7,ME13 7,Total,4197,4069,128
2011,ME13 8,ME13 8,Total,4406,4276,130
2011,ME13 9,ME13 9,Total,2183,2081,102
2011,ME14 1,ME14 1,Total,1442,1310,132
2011,ME14 2,ME14 2,Total,4570,4397,173
2011,ME14 3,ME14 3,Total,821,784,37
2011,ME14 4,ME14 4,Total,2609,2502,107
2011,ME14 5,ME14 5,Total,3945,3853,92
2011,ME15 0,ME15 0,Total,1664,1606,58
2011,ME15 6,ME15 6,Total,4527,4379,148
2011,ME15 7,ME15 7,Total,4489,4381,108
2011,ME15 8,ME15 8,Total,4764,4662,102
2011,ME15 9,ME15 9,Total,4530,4441,89
2011,ME16 0,ME16 0,Total,5778,5614,164
2011,ME16 8,ME16 8,Total,5060,4861,199
2011,ME16 9,ME16 9,Total,2194,2136,58
2011,ME17 1,ME17 1,Total,1978,1895,83
2011,ME17 2,ME17 2,Total,1740,1654,86
2011,ME17 3,ME17 3,Total,2352,2243,109
2011,ME17 4,ME17 4,Total,3338,3250,88
2011,ME18 5,ME18 5,Total,2038,1932,106
2011,ME18 6,ME18 6,Total,932,904,28
2011,ME19 4,ME19 4,Total,2778,2683,95
2011,ME19 5,ME19 5,Total,2644,2513,131
2011,ME19 6,ME19 6,Total,3289,3156,133
2011,ME2  1,ME2  1,Total,2281,2211,70
2011,ME2  2,ME2  2,Total,6053,5791,262
2011,ME2  3,ME2  3,Total,5101,4934,167
2011,ME2  4,ME2  4,Total,2978,2879,99
2011,ME20 6,ME20 6,Total,5437,5308,129
2011,ME20 7,ME20 7,Total,3077,2981,96
2011,ME3  0,ME3  0,Total,662,630,32
2011,ME3  7,ME3  7,Total,2644,2560,84
2011,ME3  8,ME3  8,Total,3343,3237,106
2011,ME3  9,ME3  9,Total,4531,4135,396
2011,ME4  3,ME4  3,Total,1197,1162,35
2011,ME4  4,ME4  4,Total,1819,1527,292
2011,ME4  5,ME4  5,Total,5733,5458,275
2011,ME4  6,ME4  6,Total,3908,3779,129
2011,ME5  0,ME5  0,Total,4954,4874,80
2011,ME5  7,ME5  7,Total,5309,5124,185
2011,ME5  8,ME5  8,Total,6067,5952,115
2011,ME5  9,ME5  9,Total,4832,4706,126
2011,ME6  5,ME6  5,Total,4474,4288,186
2011,ME7  1,ME7  1,Total,4713,4499,214
2011,ME7  2,ME7  2,Total,4971,4856,115
2011,ME7  3,ME7  3,Total,3373,3297,76
2011,ME7  4,ME7  4,Total,4016,3823,193
2011,ME7  5,ME7  5,Total,3991,3754,237
2011,ME8  0,ME8  0,Total,3847,3735,112
2011,ME8  6,ME8  6,Total,4268,4172,96
2011,ME8  7,ME8  7,Total,3386,3239,147
2011,ME8  8,ME8  8,Total,4120,4013,107
2011,ME8  9,ME8  9,Total,5261,5174,87
2011,ME9  0,ME9  0,Total,1132,1080,52
2011,ME9  7,ME9  7,Total,2853,2732,121
2011,ME9  8,ME9  8,Total,2505,2393,112
2011,ME9  9,ME9  9,Total,2103,2032,71
2011,MK1  1,MK1  1,Total,355,319,36
2011,MK10 7,MK10 7,Total,964,916,48
2011,MK10 9,MK10 9,Total,4248,4117,131
2011,MK11 1,MK11 1,Total,2757,2667,90
2011,MK11 2,MK11 2,Total,625,616,9
2011,MK12 5,MK12 5,Total,3296,3060,236
2011,MK12 6,MK12 6,Total,1997,1879,118
2011,MK13 0,MK13 0,Total,2041,1944,97
2011,MK13 7,MK13 7,Total,3185,3094,91
2011,MK13 8,MK13 8,Total,1290,1261,29
2011,MK13 9,MK13 9,Total,1280,1265,15
2011,MK14 5,MK14 5,Total,2888,2796,92
2011,MK14 6,MK14 6,Total,2454,2317,137
2011,MK14 7,MK14 7,Total,2319,2208,111
2011,MK15 0,MK15 0,Total,512,480,32
2011,MK15 8,MK15 8,Total,801,786,15
2011,MK15 9,MK15 9,Total,1869,1794,75
2011,MK16 0,MK16 0,Total,2328,2271,57
2011,MK16 8,MK16 8,Total,3411,3303,108
2011,MK16 9,MK16 9,Total,2074,2015,59
2011,MK17 0,MK17 0,Total,2525,2416,109
2011,MK17 8,MK17 8,Total,3013,2868,145
2011,MK17 9,MK17 9,Total,1972,1867,105
2011,MK18 1,MK18 1,Total,3853,3678,175
2011,MK18 2,MK18 2,Total,2398,2322,76
2011,MK18 3,MK18 3,Total,2635,2539,96
2011,MK18 4,MK18 4,Total,1493,1417,76
2011,MK18 5,MK18 5,Total,721,682,39
2011,MK18 7,MK18 7,Total,1460,1414,46
2011,MK19 6,MK19 6,Total,2635,2552,83
2011,MK19 7,MK19 7,Total,2043,1988,55
2011,MK2  2,MK2  2,Total,2977,2843,134
2011,MK2  3,MK2  3,Total,3044,2867,177
2011,MK3  5,MK3  5,Total,2758,2694,64
2011,MK3  6,MK3  6,Total,2345,2304,41
2011,MK3  7,MK3  7,Total,4228,4168,60
2011,MK4  1,MK4  1,Total,2346,2310,36
2011,MK4  2,MK4  2,Total,2161,2127,34
2011,MK4  3,MK4  3,Total,1336,1318,18
2011,MK4  4,MK4  4,Total,2519,2461,58
2011,MK40 1,MK40 1,Total,1969,1638,331
2011,MK40 2,MK40 2,Total,3624,3289,335
2011,MK40 3,MK40 3,Total,4047,3716,331
2011,MK40 4,MK40 4,Total,4384,4058,326
2011,MK41 0,MK41 0,Total,4087,3933,154
2011,MK41 6,MK41 6,Total,1929,1855,74
2011,MK41 7,MK41 7,Total,5282,5067,215
2011,MK41 8,MK41 8,Total,3364,3271,93
2011,MK41 9,MK41 9,Total,3340,3246,94
2011,MK42 0,MK42 0,Total,5204,4881,323
2011,MK42 6,MK42 6,Total,394,368,26
2011,MK42 7,MK42 7,Total,3485,3249,236
2011,MK42 8,MK42 8,Total,4423,4226,197
2011,MK42 9,MK42 9,Total,5149,4793,356
2011,MK43 0,MK43 0,Total,4695,4562,133
2011,MK43 7,MK43 7,Total,3148,3017,131
2011,MK43 8,MK43 8,Total,3042,2955,87
2011,MK43 9,MK43 9,Total,2601,2506,95
2011,MK44 1,MK44 1,Total,2262,2117,145
2011,MK44 2,MK44 2,Total,1531,1462,69
2011,MK44 3,MK44 3,Total,2949,2801,148
2011,MK45 1,MK45 1,Total,5304,5188,116
2011,MK45 2,MK45 2,Total,4350,4219,131
2011,MK45 3,MK45 3,Total,2578,2487,91
2011,MK45 4,MK45 4,Total,3846,3694,152
2011,MK45 5,MK45 5,Total,2024,1958,66
2011,MK46 4,MK46 4,Total,1435,1367,68
2011,MK46 5,MK46 5,Total,2543,2467,76
2011,MK5  6,MK5  6,Total,2054,1991,63
2011,MK5  7,MK5  7,Total,2524,2487,37
2011,MK5  8,MK5  8,Total,1267,1238,29
2011,MK6  2,MK6  2,Total,3879,3759,120
2011,MK6  3,MK6  3,Total,2304,2234,70
2011,MK6  4,MK6  4,Total,2394,2344,50
2011,MK6  5,MK6  5,Total,2216,2154,62
2011,MK7  6,MK7  6,Total,1002,980,22
2011,MK7  7,MK7  7,Total,2936,2864,72
2011,MK7  8,MK7  8,Total,2031,1995,36
2011,MK8  0,MK8  0,Total,1731,1699,32
2011,MK8  8,MK8  8,Total,1821,1796,25
2011,MK8  9,MK8  9,Total,1200,1180,20
2011,MK9  2,MK9  2,Total,1070,884,186
2011,MK9  3,MK9  3,Total,894,769,125
2011,MK9  4,MK9  4,Total,231,203,28
2011,N1   0,N1   0,Total,4872,4664,208
2011,N1   1,N1   1,Total,4581,4262,319
2011,N1   2,N1   2,Total,5668,5393,275
2011,N1   3,N1   3,Total,4020,3924,96
2011,N1   4,N1   4,Total,4112,3983,129
2011,N1   5,N1   5,Total,4127,4064,63
2011,N1   6,N1   6,Total,3590,3546,44
2011,N1   7,N1   7,Total,5296,5203,93
2011,N1   8,N1   8,Total,3761,3625,136
2011,N1   9,N1   9,Total,3165,2929,236
2011,N10  1,N10  1,Total,3599,3508,91
2011,N10  2,N10  2,Total,4087,4008,79
2011,N10  3,N10  3,Total,4063,3944,119
2011,N11  1,N11  1,Total,3816,3732,84
2011,N11  2,N11  2,Total,4245,4164,81
2011,N11  3,N11  3,Total,3900,3776,124
2011,N12  0,N12  0,Total,3237,3172,65
2011,N12  7,N12  7,Total,2063,2016,47
2011,N12  8,N12  8,Total,3517,3407,110
2011,N12  9,N12  9,Total,2938,2886,52
2011,N13  4,N13  4,Total,5328,5173,155
2011,N13  5,N13  5,Total,4877,4814,63
2011,N13  6,N13  6,Total,2375,2338,37
2011,N14  4,N14  4,Total,4343,4240,103
2011,N14  5,N14  5,Total,2317,2276,41
2011,N14  6,N14  6,Total,2820,2744,76
2011,N14  7,N14  7,Total,2150,2115,35
2011,N15  3,N15  3,Total,4306,4108,198
2011,N15  4,N15  4,Total,4387,4203,184
2011,N15  5,N15  5,Total,3832,3756,76
2011,N15  6,N15  6,Total,4705,4426,279
2011,N16  0,N16  0,Total,3629,3565,64
2011,N16  5,N16  5,Total,5858,5658,200
2011,N16  6,N16  6,Total,4961,4829,132
2011,N16  7,N16  7,Total,4856,4747,109
2011,N16  8,N16  8,Total,4988,4863,125
2011,N16  9,N16  9,Total,2716,2612,104
2011,N17  0,N17  0,Total,4508,4281,227
2011,N17  6,N17  6,Total,8351,7848,503
2011,N17  7,N17  7,Total,3682,3610,72
2011,N17  8,N17  8,Total,3223,3121,102
2011,N17  9,N17  9,Total,4946,4813,133
2011,N18  1,N18  1,Total,5594,5514,80
2011,N18  2,N18  2,Total,5991,5908,83
2011,N19  3,N19  3,Total,5712,5549,163
2011,N19  4,N19  4,Total,4821,4668,153
2011,N19  5,N19  5,Total,5059,4901,158
2011,N2   0,N2   0,Total,4209,3976,233
2011,N2   8,N2   8,Total,2762,2710,52
2011,N2   9,N2   9,Total,3041,2950,91
2011,N20  0,N20  0,Total,4348,4251,97
2011,N20  8,N20  8,Total,1557,1486,71
2011,N20  9,N20  9,Total,1624,1581,43
2011,N21  1,N21  1,Total,3669,3586,83
2011,N21  2,N21  2,Total,2708,2650,58
2011,N21  3,N21  3,Total,3064,3011,53
2011,N22  5,N22  5,Total,5352,5236,116
2011,N22  6,N22  6,Total,5035,4941,94
2011,N22  7,N22  7,Total,3019,2966,53
2011,N22  8,N22  8,Total,4044,3969,75
2011,N3   1,N3   1,Total,3736,3643,93
2011,N3   2,N3   2,Total,3739,3637,102
2011,N3   3,N3   3,Total,3331,3198,133
2011,N4   1,N4   1,Total,5480,5045,435
2011,N4   2,N4   2,Total,7432,6995,437
2011,N4   3,N4   3,Total,5581,5285,296
2011,N4   4,N4   4,Total,3400,3145,255
2011,N5   1,N5   1,Total,5733,5486,247
2011,N5   2,N5   2,Total,5740,5584,156
2011,N6   4,N6   4,Total,2310,2203,107
2011,N6   5,N6   5,Total,5367,5180,187
2011,N6   6,N6   6,Total,1677,1550,127
2011,N7   0,N7   0,Total,5940,5701,239
2011,N7   6,N7   6,Total,3331,3128,203
2011,N7   7,N7   7,Total,3268,3149,119
2011,N7   8,N7   8,Total,5354,5081,273
2011,N7   9,N7   9,Total,4421,4267,154
2011,N8   0,N8   0,Total,4856,4554,302
2011,N8   7,N8   7,Total,4569,4452,117
2011,N8   8,N8   8,Total,3808,3708,100
2011,N8   9,N8   9,Total,4803,4654,149
2011,N9   0,N9   0,Total,4770,4701,69
2011,N9   7,N9   7,Total,3833,3781,52
2011,N9   8,N9   8,Total,4804,4725,79
2011,N9   9,N9   9,Total,6473,6333,140
2011,NE1  2,NE1  2,Total,1490,1388,102
2011,NE1  3,NE1  3,Total,452,396,56
2011,NE1  4,NE1  4,Total,1133,1058,75
2011,NE1  5,NE1  5,Total,641,577,64
2011,NE1  6,NE1  6,Total,435,377,58
2011,NE1  8,NE1  8,Total,286,275,11
2011,NE10 0,NE10 0,Total,4533,4245,288
2011,NE10 8,NE10 8,Total,7874,7735,139
2011,NE10 9,NE10 9,Total,4438,4304,134
2011,NE11 0,NE11 0,Total,1880,1834,46
2011,NE11 9,NE11 9,Total,5508,5346,162
2011,NE12 5,NE12 5,Total,844,829,15
2011,NE12 6,NE12 6,Total,3859,3794,65
2011,NE12 7,NE12 7,Total,2289,2246,43
2011,NE12 8,NE12 8,Total,4830,4740,90
2011,NE12 9,NE12 9,Total,4338,4214,124
2011,NE13 6,NE13 6,Total,2747,2666,81
2011,NE13 7,NE13 7,Total,2465,2377,88
2011,NE13 8,NE13 8,Total,465,446,19
2011,NE13 9,NE13 9,Total,408,391,17
2011,NE15 0,NE15 0,Total,988,932,56
2011,NE15 6,NE15 6,Total,2635,2576,59
2011,NE15 7,NE15 7,Total,4063,3982,81
2011,NE15 8,NE15 8,Total,4165,4024,141
2011,NE15 9,NE15 9,Total,2797,2727,70
2011,NE16 3,NE16 3,Total,1507,1428,79
2011,NE16 4,NE16 4,Total,2970,2868,102
2011,NE16 5,NE16 5,Total,4850,4770,80
2011,NE16 6,NE16 6,Total,2315,2245,70
2011,NE17 7,NE17 7,Total,2337,2167,170
2011,NE18 0,NE18 0,Total,417,387,30
2011,NE19 1,NE19 1,Total,609,537,72
2011,NE19 2,NE19 2,Total,475,442,33
2011,NE2  1,NE2  1,Total,3891,3742,149
2011,NE2  2,NE2  2,Total,2711,2564,147
2011,NE2  3,NE2  3,Total,2594,2480,114
2011,NE2  4,NE2  4,Total,1722,1617,105
2011,NE20 0,NE20 0,Total,598,550,48
2011,NE20 9,NE20 9,Total,4529,4322,207
2011,NE21 4,NE21 4,Total,2502,2380,122
2011,NE21 5,NE21 5,Total,2389,2305,84
2011,NE21 6,NE21 6,Total,2968,2897,71
2011,NE22 5,NE22 5,Total,4169,4038,131
2011,NE22 6,NE22 6,Total,2425,2374,51
2011,NE22 7,NE22 7,Total,1516,1426,90
2011,NE23 1,NE23 1,Total,1593,1570,23
2011,NE23 2,NE23 2,Total,2349,2312,37
2011,NE23 3,NE23 3,Total,2194,2170,24
2011,NE23 6,NE23 6,Total,5242,5111,131
2011,NE23 7,NE23 7,Total,4882,4750,132
2011,NE23 8,NE23 8,Total,1114,1088,26
2011,NE24 1,NE24 1,Total,1963,1777,186
2011,NE24 2,NE24 2,Total,3096,2947,149
2011,NE24 3,NE24 3,Total,4901,4796,105
2011,NE24 4,NE24 4,Total,3262,3173,89
2011,NE24 5,NE24 5,Total,4161,4048,113
2011,NE25 0,NE25 0,Total,4449,4313,136
2011,NE25 8,NE25 8,Total,3968,3849,119
2011,NE25 9,NE25 9,Total,5080,4947,133
2011,NE26 1,NE26 1,Total,2148,2065,83
2011,NE26 2,NE26 2,Total,2141,1991,150
2011,NE26 3,NE26 3,Total,2340,2251,89
2011,NE26 4,NE26 4,Total,2062,2008,54
2011,NE27 0,NE27 0,Total,5294,5122,172
2011,NE28 0,NE28 0,Total,4010,3891,119
2011,NE28 6,NE28 6,Total,2893,2642,251
2011,NE28 7,NE28 7,Total,3870,3699,171
2011,NE28 8,NE28 8,Total,4597,4432,165
2011,NE28 9,NE28 9,Total,6063,5860,203
2011,NE29 0,NE29 0,Total,3189,3093,96
2011,NE29 6,NE29 6,Total,4300,4111,189
2011,NE29 7,NE29 7,Total,3889,3771,118
2011,NE29 8,NE29 8,Total,4023,3921,102
2011,NE29 9,NE29 9,Total,1901,1830,71
2011,NE3  1,NE3  1,Total,4197,4014,183
2011,NE3  2,NE3  2,Total,6087,5889,198
2011,NE3  3,NE3  3,Total,5045,4923,122
2011,NE3  4,NE3  4,Total,4500,4367,133
2011,NE3  5,NE3  5,Total,3422,3235,187
2011,NE30 1,NE30 1,Total,881,791,90
2011,NE30 2,NE30 2,Total,3833,3705,128
2011,NE30 3,NE30 3,Total,3800,3726,74
2011,NE30 4,NE30 4,Total,2768,2582,186
2011,NE31 1,NE31 1,Total,4662,4506,156
2011,NE31 2,NE31 2,Total,4616,4504,112
2011,NE32 3,NE32 3,Total,2506,2396,110
2011,NE32 4,NE32 4,Total,4722,4628,94
2011,NE32 5,NE32 5,Total,4384,4276,108
2011,NE33 1,NE33 1,Total,811,765,46
2011,NE33 2,NE33 2,Total,2847,2672,175
2011,NE33 3,NE33 3,Total,3944,3776,168
2011,NE33 4,NE33 4,Total,3962,3714,248
2011,NE33 5,NE33 5,Total,2512,2344,168
2011,NE34 0,NE34 0,Total,5031,4812,219
2011,NE34 6,NE34 6,Total,4153,4033,120
2011,NE34 7,NE34 7,Total,5151,4991,160
2011,NE34 8,NE34 8,Total,4762,4647,115
2011,NE34 9,NE34 9,Total,5111,4936,175
2011,NE35 9,NE35 9,Total,2909,2805,104
2011,NE36 0,NE36 0,Total,3155,3035,120
2011,NE37 1,NE37 1,Total,4043,3974,69
2011,NE37 2,NE37 2,Total,3274,3190,84
2011,NE37 3,NE37 3,Total,1931,1872,59
2011,NE38 0,NE38 0,Total,4009,3944,65
2011,NE38 7,NE38 7,Total,4108,4004,104
2011,NE38 8,NE38 8,Total,3203,3120,83
2011,NE38 9,NE38 9,Total,2185,2142,43
2011,NE39 1,NE39 1,Total,1790,1738,52
2011,NE39 2,NE39 2,Total,2033,1966,67
2011,NE4  5,NE4  5,Total,3117,2996,121
2011,NE4  6,NE4  6,Total,3419,2914,505
2011,NE4  7,NE4  7,Total,1433,1325,108
2011,NE4  8,NE4  8,Total,3085,2897,188
2011,NE4  9,NE4  9,Total,4208,4068,140
2011,NE40 3,NE40 3,Total,3457,3360,97
2011,NE40 4,NE40 4,Total,3595,3489,106
2011,NE41 8,NE41 8,Total,1001,950,51
2011,NE42 5,NE42 5,Total,2996,2913,83
2011,NE42 6,NE42 6,Total,2437,2368,69
2011,NE43 7,NE43 7,Total,1977,1895,82
2011,NE44 6,NE44 6,Total,427,407,20
2011,NE45 5,NE45 5,Total,1811,1684,127
2011,NE46 1,NE46 1,Total,1937,1831,106
2011,NE46 2,NE46 2,Total,1918,1852,66
2011,NE46 3,NE46 3,Total,1709,1602,107
2011,NE46 4,NE46 4,Total,1540,1460,80
2011,NE47 0,NE47 0,Total,458,418,40
2011,NE47 5,NE47 5,Total,403,386,17
2011,NE47 6,NE47 6,Total,1011,943,68
2011,NE47 7,NE47 7,Total,508,474,34
2011,NE47 8,NE47 8,Total,236,203,33
2011,NE47 9,NE47 9,Total,1039,917,122
2011,NE48 1,NE48 1,Total,426,363,63
2011,NE48 2,NE48 2,Total,912,824,88
2011,NE48 3,NE48 3,Total,533,495,38
2011,NE48 4,NE48 4,Total,265,245,20
2011,NE49 0,NE49 0,Total,579,512,67
2011,NE49 9,NE49 9,Total,1568,1497,71
2011,NE5  1,NE5  1,Total,3886,3837,49
2011,NE5  2,NE5  2,Total,6457,6336,121
2011,NE5  3,NE5  3,Total,4449,4265,184
2011,NE5  4,NE5  4,Total,3865,3765,100
2011,NE5  5,NE5  5,Total,3167,3112,55
2011,NE6  1,NE6  1,Total,1765,1688,77
2011,NE6  2,NE6  2,Total,5766,5569,197
2011,NE6  3,NE6  3,Total,3935,3852,83
2011,NE6  4,NE6  4,Total,5500,5355,145
2011,NE6  5,NE6  5,Total,6848,6548,300
2011,NE61 1,NE61 1,Total,2027,1927,100
2011,NE61 2,NE61 2,Total,4018,3908,110
2011,NE61 3,NE61 3,Total,1667,1603,64
2011,NE61 4,NE61 4,Total,602,548,54
2011,NE61 5,NE61 5,Total,3729,3554,175
2011,NE61 6,NE61 6,Total,2237,2155,82
2011,NE62 5,NE62 5,Total,4493,4324,169
2011,NE63 0,NE63 0,Total,3997,3799,198
2011,NE63 8,NE63 8,Total,3823,3710,113
2011,NE63 9,NE63 9,Total,5276,4901,375
2011,NE64 6,NE64 6,Total,3089,2853,236
2011,NE65 0,NE65 0,Total,3877,3564,313
2011,NE65 7,NE65 7,Total,2078,1815,263
2011,NE65 8,NE65 8,Total,1019,945,74
2011,NE65 9,NE65 9,Total,2664,2505,159
2011,NE66 1,NE66 1,Total,3439,3150,289
2011,NE66 2,NE66 2,Total,1947,1745,202
2011,NE66 3,NE66 3,Total,2446,1945,501
2011,NE66 4,NE66 4,Total,844,695,149
2011,NE66 5,NE66 5,Total,196,159,37
2011,NE67 5,NE67 5,Total,871,447,424
2011,NE68 7,NE68 7,Total,1341,952,389
2011,NE69 7,NE69 7,Total,420,222,198
2011,NE7  7,NE7  7,Total,6408,6185,223
2011,NE70 7,NE70 7,Total,1026,808,218
2011,NE71 6,NE71 6,Total,1740,1443,297
2011,NE8  1,NE8  1,Total,2561,2391,170
2011,NE8  2,NE8  2,Total,3915,3679,236
2011,NE8  3,NE8  3,Total,4320,4026,294
2011,NE8  4,NE8  4,Total,5872,5430,442
2011,NE9  5,NE9  5,Total,4642,4500,142
2011,NE9  6,NE9  6,Total,6997,6867,130
2011,NE9  7,NE9  7,Total,5283,5181,102
2011,NG1  1,NG1  1,Total,2379,2162,217
2011,NG1  3,NG1  3,Total,1548,1470,78
2011,NG1  4,NG1  4,Total,1231,1196,35
2011,NG1  5,NG1  5,Total,875,807,68
2011,NG1  6,NG1  6,Total,167,146,21
2011,NG1  7,NG1  7,Total,382,258,124
2011,NG10 1,NG10 1,Total,3822,3658,164
2011,NG10 2,NG10 2,Total,2143,2072,71
2011,NG10 3,NG10 3,Total,6389,6231,158
2011,NG10 4,NG10 4,Total,4911,4713,198
2011,NG10 5,NG10 5,Total,4023,3827,196
2011,NG11 0,NG11 0,Total,1115,1073,42
2011,NG11 6,NG11 6,Total,3661,3541,120
2011,NG11 7,NG11 7,Total,1987,1952,35
2011,NG11 8,NG11 8,Total,5832,5721,111
2011,NG11 9,NG11 9,Total,3934,3847,87
2011,NG12 1,NG12 1,Total,1113,1087,26
2011,NG12 2,NG12 2,Total,2961,2844,117
2011,NG12 3,NG12 3,Total,4588,4483,105
2011,NG12 4,NG12 4,Total,2113,2035,78
2011,NG12 5,NG12 5,Total,3773,3620,153
2011,NG13 0,NG13 0,Total,1979,1919,60
2011,NG13 8,NG13 8,Total,5154,4990,164
2011,NG13 9,NG13 9,Total,1884,1819,65
2011,NG14 5,NG14 5,Total,1771,1708,63
2011,NG14 6,NG14 6,Total,4263,4121,142
2011,NG14 7,NG14 7,Total,2141,2089,52
2011,NG15 0,NG15 0,Total,944,884,60
2011,NG15 6,NG15 6,Total,6316,6167,149
2011,NG15 7,NG15 7,Total,6061,5774,287
2011,NG15 8,NG15 8,Total,2253,2188,65
2011,NG15 9,NG15 9,Total,2584,2508,76
2011,NG16 1,NG16 1,Total,3925,3795,130
2011,NG16 2,NG16 2,Total,7362,7129,233
2011,NG16 3,NG16 3,Total,4953,4725,228
2011,NG16 4,NG16 4,Total,2467,2371,96
2011,NG16 5,NG16 5,Total,4428,4297,131
2011,NG16 6,NG16 6,Total,5061,4861,200
2011,NG17 1,NG17 1,Total,2772,2690,82
2011,NG17 2,NG17 2,Total,6531,6288,243
2011,NG17 3,NG17 3,Total,4033,3868,165
2011,NG17 4,NG17 4,Total,4388,4188,200
2011,NG17 5,NG17 5,Total,2793,2705,88
2011,NG17 7,NG17 7,Total,4046,3880,166
2011,NG17 8,NG17 8,Total,4845,4661,184
2011,NG17 9,NG17 9,Total,2800,2724,76
2011,NG18 1,NG18 1,Total,705,619,86
2011,NG18 2,NG18 2,Total,3827,3617,210
2011,NG18 3,NG18 3,Total,5139,4987,152
2011,NG18 4,NG18 4,Total,5779,5516,263
2011,NG18 5,NG18 5,Total,3549,3371,178
2011,NG19 0,NG19 0,Total,4907,4707,200
2011,NG19 6,NG19 6,Total,5423,5255,168
2011,NG19 7,NG19 7,Total,4077,3882,195
2011,NG19 8,NG19 8,Total,4595,4459,136
2011,NG19 9,NG19 9,Total,4303,4154,149
2011,NG2  1,NG2  1,Total,1113,1070,43
2011,NG2  2,NG2  2,Total,2624,2508,116
2011,NG2  3,NG2  3,Total,1011,923,88
2011,NG2  4,NG2  4,Total,4918,4634,284
2011,NG2  5,NG2  5,Total,3751,3639,112
2011,NG2  6,NG2  6,Total,5462,5299,163
2011,NG2  7,NG2  7,Total,6823,6597,226
2011,NG20 0,NG20 0,Total,4025,3867,158
2011,NG20 8,NG20 8,Total,4426,4203,223
2011,NG20 9,NG20 9,Total,2952,2797,155
2011,NG21 0,NG21 0,Total,5285,5116,169
2011,NG21 9,NG21 9,Total,4338,4175,163
2011,NG22 0,NG22 0,Total,3079,2907,172
2011,NG22 8,NG22 8,Total,3252,3125,127
2011,NG22 9,NG22 9,Total,5302,5054,248
2011,NG23 5,NG23 5,Total,3101,2947,154
2011,NG23 6,NG23 6,Total,2327,2228,99
2011,NG23 7,NG23 7,Total,2181,2068,113
2011,NG24 1,NG24 1,Total,3591,3283,308
2011,NG24 2,NG24 2,Total,4501,4320,181
2011,NG24 3,NG24 3,Total,6130,5931,199
2011,NG24 4,NG24 4,Total,6551,6250,301
2011,NG25 0,NG25 0,Total,3857,3718,139
2011,NG3  1,NG3  1,Total,1768,1722,46
2011,NG3  2,NG3  2,Total,2242,2166,76
2011,NG3  3,NG3  3,Total,3286,3155,131
2011,NG3  4,NG3  4,Total,2018,1906,112
2011,NG3  5,NG3  5,Total,4575,4315,260
2011,NG3  6,NG3  6,Total,5180,4968,212
2011,NG3  7,NG3  7,Total,2925,2860,65
2011,NG31 6,NG31 6,Total,2076,1876,200
2011,NG31 7,NG31 7,Total,5942,5646,296
2011,NG31 8,NG31 8,Total,6043,5930,113
2011,NG31 9,NG31 9,Total,5728,5582,146
2011,NG32 1,NG32 1,Total,1946,1870,76
2011,NG32 2,NG32 2,Total,1571,1521,50
2011,NG32 3,NG32 3,Total,2094,2019,75
2011,NG33 4,NG33 4,Total,2128,2034,94
2011,NG33 5,NG33 5,Total,2308,2198,110
2011,NG34 0,NG34 0,Total,2658,2549,109
2011,NG34 7,NG34 7,Total,5903,5722,181
2011,NG34 8,NG34 8,Total,4834,4586,248
2011,NG34 9,NG34 9,Total,5095,4950,145
2011,NG4  1,NG4  1,Total,5848,5697,151
2011,NG4  2,NG4  2,Total,4121,3958,163
2011,NG4  3,NG4  3,Total,4547,4422,125
2011,NG4  4,NG4  4,Total,3787,3689,98
2011,NG5  1,NG5  1,Total,3981,3841,140
2011,NG5  2,NG5  2,Total,2901,2753,148
2011,NG5  3,NG5  3,Total,2166,2108,58
2011,NG5  4,NG5  4,Total,4315,4177,138
2011,NG5  5,NG5  5,Total,7573,7401,172
2011,NG5  6,NG5  6,Total,5468,5313,155
2011,NG5  7,NG5  7,Total,3360,3259,101
2011,NG5  8,NG5  8,Total,5121,5021,100
2011,NG5  9,NG5  9,Total,4270,4131,139
2011,NG6  0,NG6  0,Total,4130,3984,146
2011,NG6  7,NG6  7,Total,2013,1979,34
2011,NG6  8,NG6  8,Total,7108,6875,233
2011,NG6  9,NG6  9,Total,3862,3728,134
2011,NG7  1,NG7  1,Total,4666,4441,225
2011,NG7  2,NG7  2,Total,3386,3195,191
2011,NG7  3,NG7  3,Total,2859,2711,148
2011,NG7  4,NG7  4,Total,2100,1902,198
2011,NG7  5,NG7  5,Total,3145,2951,194
2011,NG7  6,NG7  6,Total,3612,3332,280
2011,NG7  7,NG7  7,Total,2049,1902,147
2011,NG8  1,NG8  1,Total,3915,3750,165
2011,NG8  2,NG8  2,Total,4871,4750,121
2011,NG8  3,NG8  3,Total,4226,4090,136
2011,NG8  4,NG8  4,Total,3405,3303,102
2011,NG8  5,NG8  5,Total,5355,5174,181
2011,NG8  6,NG8  6,Total,4766,4631,135
2011,NG9  1,NG9  1,Total,4632,4469,163
2011,NG9  2,NG9  2,Total,5411,5024,387
2011,NG9  3,NG9  3,Total,4938,4795,143
2011,NG9  4,NG9  4,Total,2623,2505,118
2011,NG9  5,NG9  5,Total,3603,3488,115
2011,NG9  6,NG9  6,Total,3930,3845,85
2011,NG9  7,NG9  7,Total,2653,2546,107
2011,NG9  8,NG9  8,Total,4121,3973,148
2011,NN1  1,NN1  1,Total,1102,1023,79
2011,NN1  2,NN1  2,Total,1775,1704,71
2011,NN1  3,NN1  3,Total,2969,2762,207
2011,NN1  4,NN1  4,Total,4789,4511,278
2011,NN1  5,NN1  5,Total,3724,3559,165
2011,NN10 0,NN10 0,Total,6075,5705,370
2011,NN10 6,NN10 6,Total,2394,2290,104
2011,NN10 8,NN10 8,Total,3365,3285,80
2011,NN10 9,NN10 9,Total,4848,4654,194
2011,NN11 0,NN11 0,Total,2118,2087,31
2011,NN11 2,NN11 2,Total,600,576,24
2011,NN11 3,NN11 3,Total,2786,2648,138
2011,NN11 4,NN11 4,Total,5128,5029,99
2011,NN11 6,NN11 6,Total,1332,1263,69
2011,NN11 7,NN11 7,Total,814,776,38
2011,NN11 8,NN11 8,Total,629,610,19
2011,NN11 9,NN11 9,Total,2660,2619,41
2011,NN12 6,NN12 6,Total,3383,3283,100
2011,NN12 7,NN12 7,Total,2509,2424,85
2011,NN12 8,NN12 8,Total,3946,3797,149
2011,NN13 5,NN13 5,Total,2344,2187,157
2011,NN13 6,NN13 6,Total,4207,4082,125
2011,NN13 7,NN13 7,Total,1420,1312,108
2011,NN14 1,NN14 1,Total,4269,4120,149
2011,NN14 2,NN14 2,Total,4612,4390,222
2011,NN14 3,NN14 3,Total,1915,1800,115
2011,NN14 4,NN14 4,Total,4435,4272,163
2011,NN14 6,NN14 6,Total,3530,3366,164
2011,NN15 5,NN15 5,Total,6207,6010,197
2011,NN15 6,NN15 6,Total,5855,5685,170
2011,NN15 7,NN15 7,Total,2598,2531,67
2011,NN16 0,NN16 0,Total,3668,3486,182
2011,NN16 8,NN16 8,Total,3958,3646,312
2011,NN16 9,NN16 9,Total,6299,6041,258
2011,NN17 1,NN17 1,Total,4342,4185,157
2011,NN17 2,NN17 2,Total,5320,5203,117
2011,NN17 3,NN17 3,Total,1835,1699,136
2011,NN17 4,NN17 4,Total,230,218,12
2011,NN18 0,NN18 0,Total,3850,3748,102
2011,NN18 8,NN18 8,Total,5784,5521,263
2011,NN18 9,NN18 9,Total,4075,3910,165
2011,NN2  6,NN2  6,Total,4374,4167,207
2011,NN2  7,NN2  7,Total,5781,5591,190
2011,NN2  8,NN2  8,Total,6124,5997,127
2011,NN29 7,NN29 7,Total,5058,4937,121
2011,NN3  2,NN3  2,Total,4940,4780,160
2011,NN3  3,NN3  3,Total,3852,3764,88
2011,NN3  5,NN3  5,Total,3799,3699,100
2011,NN3  6,NN3  6,Total,3259,3151,108
2011,NN3  7,NN3  7,Total,2558,2499,59
2011,NN3  8,NN3  8,Total,6382,6209,173
2011,NN3  9,NN3  9,Total,4086,3952,134
2011,NN4  0,NN4  0,Total,4429,4320,109
2011,NN4  5,NN4  5,Total,1610,1562,48
2011,NN4  6,NN4  6,Total,3986,3904,82
2011,NN4  7,NN4  7,Total,280,277,3
2011,NN4  8,NN4  8,Total,6286,6136,150
2011,NN4  9,NN4  9,Total,2305,2270,35
2011,NN5  4,NN5  4,Total,1861,1809,52
2011,NN5  5,NN5  5,Total,3392,3275,117
2011,NN5  6,NN5  6,Total,7098,6938,160
2011,NN5  7,NN5  7,Total,4572,4396,176
2011,NN6  0,NN6  0,Total,3530,3405,125
2011,NN6  6,NN6  6,Total,1308,1270,38
2011,NN6  7,NN6  7,Total,3290,3177,113
2011,NN6  8,NN6  8,Total,2263,2184,79
2011,NN6  9,NN6  9,Total,3713,3602,111
2011,NN7  1,NN7  1,Total,2070,1991,79
2011,NN7  2,NN7  2,Total,2825,2761,64
2011,NN7  3,NN7  3,Total,3337,3233,104
2011,NN7  4,NN7  4,Total,3549,3455,94
2011,NN8  1,NN8  1,Total,3316,3154,162
2011,NN8  2,NN8  2,Total,4818,4711,107
2011,NN8  3,NN8  3,Total,5361,5215,146
2011,NN8  4,NN8  4,Total,4734,4480,254
2011,NN8  5,NN8  5,Total,3104,3059,45
2011,NN9  5,NN9  5,Total,6667,6424,243
2011,NN9  6,NN9  6,Total,4810,4639,171
2011,NR1  1,NR1  1,Total,3178,2859,319
2011,NR1  2,NR1  2,Total,3991,3830,161
2011,NR1  3,NR1  3,Total,2609,2489,120
2011,NR1  4,NR1  4,Total,3527,3397,130
2011,NR10 3,NR10 3,Total,4415,4319,96
2011,NR10 4,NR10 4,Total,2454,2343,111
2011,NR10 5,NR10 5,Total,2677,2538,139
2011,NR11 6,NR11 6,Total,3750,3553,197
2011,NR11 7,NR11 7,Total,1446,1295,151
2011,NR11 8,NR11 8,Total,3625,3127,498
2011,NR12 0,NR12 0,Total,2569,2046,523
2011,NR12 7,NR12 7,Total,1534,1472,62
2011,NR12 8,NR12 8,Total,3469,3059,410
2011,NR12 9,NR12 9,Total,2805,2606,199
2011,NR13 3,NR13 3,Total,3041,2913,128
2011,NR13 4,NR13 4,Total,3044,2987,57
2011,NR13 5,NR13 5,Total,3209,3155,54
2011,NR13 6,NR13 6,Total,2273,2195,78
2011,NR14 6,NR14 6,Total,3186,3053,133
2011,NR14 7,NR14 7,Total,3574,3477,97
2011,NR14 8,NR14 8,Total,3545,3458,87
2011,NR15 1,NR15 1,Total,2864,2786,78
2011,NR15 2,NR15 2,Total,3797,3690,107
2011,NR16 1,NR16 1,Total,2311,2247,64
2011,NR16 2,NR16 2,Total,2800,2679,121
2011,NR17 1,NR17 1,Total,3003,2873,130
2011,NR17 2,NR17 2,Total,3853,3738,115
2011,NR18 0,NR18 0,Total,5573,5416,157
2011,NR18 9,NR18 9,Total,1901,1830,71
2011,NR19 1,NR19 1,Total,5065,4901,164
2011,NR19 2,NR19 2,Total,4021,3871,150
2011,NR2  1,NR2  1,Total,769,656,113
2011,NR2  2,NR2  2,Total,3528,3329,199
2011,NR2  3,NR2  3,Total,5420,5157,263
2011,NR2  4,NR2  4,Total,3667,3434,233
2011,NR20 3,NR20 3,Total,3168,3060,108
2011,NR20 4,NR20 4,Total,2977,2768,209
2011,NR20 5,NR20 5,Total,2274,2114,160
2011,NR21 0,NR21 0,Total,1798,1463,335
2011,NR21 7,NR21 7,Total,1625,1457,168
2011,NR21 8,NR21 8,Total,2447,2357,90
2011,NR21 9,NR21 9,Total,2203,1862,341
2011,NR22 6,NR22 6,Total,523,395,128
2011,NR23 1,NR23 1,Total,2120,1485,635
2011,NR24 2,NR24 2,Total,2210,1948,262
2011,NR25 6,NR25 6,Total,2957,2578,379
2011,NR25 7,NR25 7,Total,2434,1603,831
2011,NR26 8,NR26 8,Total,4670,3965,705
2011,NR27 0,NR27 0,Total,2702,2336,366
2011,NR27 9,NR27 9,Total,3827,3199,628
2011,NR28 0,NR28 0,Total,4244,4054,190
2011,NR28 9,NR28 9,Total,3896,3667,229
2011,NR29 3,NR29 3,Total,3118,2954,164
2011,NR29 4,NR29 4,Total,3903,3578,325
2011,NR29 5,NR29 5,Total,2355,2063,292
2011,NR3  1,NR3  1,Total,2925,2658,267
2011,NR3  2,NR3  2,Total,3955,3771,184
2011,NR3  3,NR3  3,Total,5322,4975,347
2011,NR3  4,NR3  4,Total,4552,4344,208
2011,NR30 1,NR30 1,Total,2159,1962,197
2011,NR30 2,NR30 2,Total,2788,2432,356
2011,NR30 3,NR30 3,Total,2029,1905,124
2011,NR30 4,NR30 4,Total,3187,3084,103
2011,NR30 5,NR30 5,Total,4280,4138,142
2011,NR31 0,NR31 0,Total,3158,2976,182
2011,NR31 6,NR31 6,Total,4155,3964,191
2011,NR31 7,NR31 7,Total,4665,4556,109
2011,NR31 8,NR31 8,Total,5906,5744,162
2011,NR31 9,NR31 9,Total,4433,4206,227
2011,NR32 1,NR32 1,Total,2188,1978,210
2011,NR32 2,NR32 2,Total,4443,4115,328
2011,NR32 3,NR32 3,Total,3800,3631,169
2011,NR32 4,NR32 4,Total,5924,5680,244
2011,NR32 5,NR32 5,Total,1649,1556,93
2011,NR33 0,NR33 0,Total,4029,3643,386
2011,NR33 7,NR33 7,Total,4600,4334,266
2011,NR33 8,NR33 8,Total,5624,5474,150
2011,NR33 9,NR33 9,Total,3858,3730,128
2011,NR34 0,NR34 0,Total,1020,956,64
2011,NR34 7,NR34 7,Total,3502,3331,171
2011,NR34 8,NR34 8,Total,1402,1270,132
2011,NR34 9,NR34 9,Total,4414,4234,180
2011,NR35 1,NR35 1,Total,2621,2511,110
2011,NR35 2,NR35 2,Total,2303,2213,90
2011,NR4  6,NR4  6,Total,4129,4016,113
2011,NR4  7,NR4  7,Total,4286,4122,164
2011,NR5  0,NR5  0,Total,3837,3730,107
2011,NR5  8,NR5  8,Total,5193,5008,185
2011,NR5  9,NR5  9,Total,3457,3315,142
2011,NR6  5,NR6  5,Total,3209,3116,93
2011,NR6  6,NR6  6,Total,3488,3371,117
2011,NR6  7,NR6  7,Total,4131,4061,70
2011,NR7  0,NR7  0,Total,5987,5845,142
2011,NR7  8,NR7  8,Total,5009,4893,116
2011,NR7  9,NR7  9,Total,3505,3408,97
2011,NR8  5,NR8  5,Total,2033,1953,80
2011,NR8  6,NR8  6,Total,6597,6472,125
2011,NR9  3,NR9  3,Total,3295,3204,91
2011,NR9  4,NR9  4,Total,2104,1997,107
2011,NR9  5,NR9  5,Total,2123,2020,103
2011,NW1  0,NW1  0,Total,2992,2915,77
2011,NW1  1,NW1  1,Total,3259,3166,93
2011,NW1  2,NW1  2,Total,710,678,32
2011,NW1  3,NW1  3,Total,2711,2615,96
2011,NW1  4,NW1  4,Total,1609,1408,201
2011,NW1  5,NW1  5,Total,1598,1378,220
2011,NW1  6,NW1  6,Total,3243,2908,335
2011,NW1  7,NW1  7,Total,3329,3051,278
2011,NW1  8,NW1  8,Total,4013,3831,182
2011,NW1  9,NW1  9,Total,4437,4266,171
2011,NW10 0,NW10 0,Total,3881,3817,64
2011,NW10 1,NW10 1,Total,3519,3434,85
2011,NW10 2,NW10 2,Total,3363,3298,65
2011,NW10 3,NW10 3,Total,3241,3159,82
2011,NW10 4,NW10 4,Total,4056,3977,79
2011,NW10 5,NW10 5,Total,5652,5535,117
2011,NW10 6,NW10 6,Total,1229,1155,74
2011,NW10 7,NW10 7,Total,1305,1284,21
2011,NW10 8,NW10 8,Total,5164,5046,118
2011,NW10 9,NW10 9,Total,3846,3756,90
2011,NW11 0,NW11 0,Total,2231,2155,76
2011,NW11 6,NW11 6,Total,2695,2622,73
2011,NW11 7,NW11 7,Total,2335,2215,120
2011,NW11 8,NW11 8,Total,2699,2531,168
2011,NW11 9,NW11 9,Total,2492,2389,103
2011,NW2  1,NW2  1,Total,3295,3212,83
2011,NW2  2,NW2  2,Total,3017,2883,134
2011,NW2  3,NW2  3,Total,4870,4697,173
2011,NW2  4,NW2  4,Total,3507,3431,76
2011,NW2  5,NW2  5,Total,4138,4019,119
2011,NW2  6,NW2  6,Total,4181,4061,120
2011,NW2  7,NW2  7,Total,3336,3275,61
2011,NW3  1,NW3  1,Total,2427,2262,165
2011,NW3  2,NW3  2,Total,6183,5927,256
2011,NW3  3,NW3  3,Total,3829,3602,227
2011,NW3  4,NW3  4,Total,4735,4474,261
2011,NW3  5,NW3  5,Total,2617,2463,154
2011,NW3  6,NW3  6,Total,2878,2711,167
2011,NW3  7,NW3  7,Total,2273,2090,183
2011,NW4  1,NW4  1,Total,2570,2487,83
2011,NW4  2,NW4  2,Total,3009,2868,141
2011,NW4  3,NW4  3,Total,3345,3209,136
2011,NW4  4,NW4  4,Total,3169,3041,128
2011,NW5  1,NW5  1,Total,3743,3661,82
2011,NW5  2,NW5  2,Total,4458,4370,88
2011,NW5  3,NW5  3,Total,1600,1563,37
2011,NW5  4,NW5  4,Total,3706,3650,56
2011,NW6  1,NW6  1,Total,5311,5113,198
2011,NW6  2,NW6  2,Total,3102,3024,78
2011,NW6  3,NW6  3,Total,3619,3509,110
2011,NW6  4,NW6  4,Total,3490,3386,104
2011,NW6  5,NW6  5,Total,4930,4747,183
2011,NW6  6,NW6  6,Total,3855,3737,118
2011,NW6  7,NW6  7,Total,6041,5821,220
2011,NW7  1,NW7  1,Total,2476,2391,85
2011,NW7  2,NW7  2,Total,2837,2778,59
2011,NW7  3,NW7  3,Total,2379,2299,80
2011,NW7  4,NW7  4,Total,2126,2035,91
2011,NW8  0,NW8  0,Total,3358,3207,151
2011,NW8  6,NW8  6,Total,2196,1885,311
2011,NW8  7,NW8  7,Total,3036,2500,536
2011,NW8  8,NW8  8,Total,4420,4213,207
2011,NW8  9,NW8  9,Total,3765,3358,407
2011,NW9  0,NW9  0,Total,3290,3218,72
2011,NW9  5,NW9  5,Total,6077,5941,136
2011,NW9  6,NW9  6,Total,2646,2575,71
2011,NW9  7,NW9  7,Total,2650,2588,62
2011,NW9  8,NW9  8,Total,3348,3276,72
2011,NW9  9,NW9  9,Total,3302,3236,66
2011,OL1  2,OL1  2,Total,3003,2971,32
2011,OL1  3,OL1  3,Total,1688,1675,13
2011,OL1  4,OL1  4,Total,3913,3794,119
2011,OL10 1,OL10 1,Total,1710,1635,75
2011,OL10 2,OL10 2,Total,3107,3021,86
2011,OL10 3,OL10 3,Total,3636,3532,104
2011,OL10 4,OL10 4,Total,4176,4026,150
2011,OL11 1,OL11 1,Total,2210,2110,100
2011,OL11 2,OL11 2,Total,4787,4627,160
2011,OL11 3,OL11 3,Total,3702,3562,140
2011,OL11 4,OL11 4,Total,3024,2926,98
2011,OL11 5,OL11 5,Total,4927,4826,101
2011,OL12 0,OL12 0,Total,2203,2135,68
2011,OL12 6,OL12 6,Total,5239,5108,131
2011,OL12 7,OL12 7,Total,4177,4091,86
2011,OL12 8,OL12 8,Total,3447,3292,155
2011,OL12 9,OL12 9,Total,4310,4273,37
2011,OL13 0,OL13 0,Total,1924,1735,189
2011,OL13 8,OL13 8,Total,2028,1870,158
2011,OL13 9,OL13 9,Total,3132,2911,221
2011,OL14 5,OL14 5,Total,2310,2154,156
2011,OL14 6,OL14 6,Total,1669,1588,81
2011,OL14 7,OL14 7,Total,1450,1369,81
2011,OL14 8,OL14 8,Total,1952,1859,93
2011,OL15 0,OL15 0,Total,1758,1694,64
2011,OL15 8,OL15 8,Total,2310,2289,21
2011,OL15 9,OL15 9,Total,2257,2217,40
2011,OL16 1,OL16 1,Total,183,167,16
2011,OL16 2,OL16 2,Total,3457,3424,33
2011,OL16 3,OL16 3,Total,3663,3553,110
2011,OL16 4,OL16 4,Total,4932,4799,133
2011,OL16 5,OL16 5,Total,2543,2434,109
2011,OL2  5,OL2  5,Total,4583,4485,98
2011,OL2  6,OL2  6,Total,5569,5425,144
2011,OL2  7,OL2  7,Total,4794,4654,140
2011,OL2  8,OL2  8,Total,3870,3733,137
2011,OL3  5,OL3  5,Total,3270,3101,169
2011,OL3  6,OL3  6,Total,1389,1318,71
2011,OL3  7,OL3  7,Total,2153,2063,90
2011,OL4  1,OL4  1,Total,3657,3470,187
2011,OL4  2,OL4  2,Total,4296,4126,170
2011,OL4  3,OL4  3,Total,2749,2629,120
2011,OL4  4,OL4  4,Total,3308,3226,82
2011,OL4  5,OL4  5,Total,4082,3890,192
2011,OL5  0,OL5  0,Total,2476,2324,152
2011,OL5  9,OL5  9,Total,2736,2600,136
2011,OL6  6,OL6  6,Total,2507,2302,205
2011,OL6  7,OL6  7,Total,1504,1414,90
2011,OL6  8,OL6  8,Total,4307,4154,153
2011,OL6  9,OL6  9,Total,4786,4501,285
2011,OL7  0,OL7  0,Total,2690,2492,198
2011,OL7  9,OL7  9,Total,4808,4613,195
2011,OL8  1,OL8  1,Total,3393,3173,220
2011,OL8  2,OL8  2,Total,3976,3825,151
2011,OL8  3,OL8  3,Total,4487,4301,186
2011,OL8  4,OL8  4,Total,3118,2966,152
2011,OL9  0,OL9  0,Total,3553,3503,50
2011,OL9  6,OL9  6,Total,2196,2168,28
2011,OL9  7,OL9  7,Total,2538,2414,124
2011,OL9  8,OL9  8,Total,4113,3967,146
2011,OL9  9,OL9  9,Total,3956,3823,133
2011,OX1  1,OX1  1,Total,1635,1458,177
2011,OX1  2,OX1  2,Total,533,469,64
2011,OX1  3,OX1  3,Total,305,255,50
2011,OX1  4,OX1  4,Total,2418,2309,109
2011,OX1  5,OX1  5,Total,2571,2486,85
2011,OX10 0,OX10 0,Total,2534,2429,105
2011,OX10 6,OX10 6,Total,2577,2416,161
2011,OX10 7,OX10 7,Total,2170,2098,72
2011,OX10 8,OX10 8,Total,1329,1288,41
2011,OX10 9,OX10 9,Total,2307,2231,76
2011,OX11 0,OX11 0,Total,2250,2209,41
2011,OX11 7,OX11 7,Total,5308,5176,132
2011,OX11 8,OX11 8,Total,3755,3637,118
2011,OX11 9,OX11 9,Total,2466,2398,68
2011,OX12 0,OX12 0,Total,2566,2515,51
2011,OX12 7,OX12 7,Total,2176,2136,40
2011,OX12 8,OX12 8,Total,2108,2025,83
2011,OX12 9,OX12 9,Total,3924,3763,161
2011,OX13 5,OX13 5,Total,1959,1903,56
2011,OX13 6,OX13 6,Total,3198,3074,124
2011,OX14 1,OX14 1,Total,4253,4160,93
2011,OX14 2,OX14 2,Total,3184,3140,44
2011,OX14 3,OX14 3,Total,3675,3576,99
2011,OX14 4,OX14 4,Total,3222,3141,81
2011,OX14 5,OX14 5,Total,4542,4406,136
2011,OX15 0,OX15 0,Total,1156,1107,49
2011,OX15 4,OX15 4,Total,2827,2683,144
2011,OX15 5,OX15 5,Total,2377,2227,150
2011,OX15 6,OX15 6,Total,1450,1366,84
2011,OX16 0,OX16 0,Total,4353,4227,126
2011,OX16 1,OX16 1,Total,4226,4147,79
2011,OX16 2,OX16 2,Total,1389,1279,110
2011,OX16 3,OX16 3,Total,2071,2003,68
2011,OX16 4,OX16 4,Total,1684,1623,61
2011,OX16 5,OX16 5,Total,1516,1339,177
2011,OX16 9,OX16 9,Total,4635,4507,128
2011,OX17 1,OX17 1,Total,1988,1852,136
2011,OX17 2,OX17 2,Total,2774,2643,131
2011,OX17 3,OX17 3,Total,2671,2570,101
2011,OX18 1,OX18 1,Total,2786,2733,53
2011,OX18 2,OX18 2,Total,2418,2309,109
2011,OX18 3,OX18 3,Total,3676,3527,149
2011,OX18 4,OX18 4,Total,1608,1399,209
2011,OX2  0,OX2  0,Total,1867,1774,93
2011,OX2  6,OX2  6,Total,3937,3629,308
2011,OX2  7,OX2  7,Total,4031,3788,243
2011,OX2  8,OX2  8,Total,2764,2651,113
2011,OX2  9,OX2  9,Total,4010,3893,117
2011,OX20 1,OX20 1,Total,2274,2107,167
2011,OX25 1,OX25 1,Total,652,633,19
2011,OX25 2,OX25 2,Total,927,871,56
2011,OX25 3,OX25 3,Total,229,218,11
2011,OX25 4,OX25 4,Total,549,524,25
2011,OX25 5,OX25 5,Total,786,739,47
2011,OX25 6,OX25 6,Total,462,440,22
2011,OX26 1,OX26 1,Total,346,330,16
2011,OX26 2,OX26 2,Total,3595,3531,64
2011,OX26 3,OX26 3,Total,2726,2683,43
2011,OX26 4,OX26 4,Total,2280,2246,34
2011,OX26 5,OX26 5,Total,506,490,16
2011,OX26 6,OX26 6,Total,4089,3937,152
2011,OX27 0,OX27 0,Total,409,390,19
2011,OX27 7,OX27 7,Total,853,823,30
2011,OX27 8,OX27 8,Total,1146,1060,86
2011,OX27 9,OX27 9,Total,249,236,13
2011,OX28 1,OX28 1,Total,3168,3097,71
2011,OX28 2,OX28 2,Total,374,367,7
2011,OX28 3,OX28 3,Total,1344,1326,18
2011,OX28 4,OX28 4,Total,749,731,18
2011,OX28 5,OX28 5,Total,3678,3628,50
2011,OX28 6,OX28 6,Total,2372,2272,100
2011,OX29 0,OX29 0,Total,612,578,34
2011,OX29 4,OX29 4,Total,2362,2277,85
2011,OX29 5,OX29 5,Total,581,546,35
2011,OX29 6,OX29 6,Total,1056,1008,48
2011,OX29 7,OX29 7,Total,1479,1425,54
2011,OX29 8,OX29 8,Total,2687,2604,83
2011,OX29 9,OX29 9,Total,1011,952,59
2011,OX3  0,OX3  0,Total,3701,3555,146
2011,OX3  7,OX3  7,Total,4631,4487,144
2011,OX3  8,OX3  8,Total,5014,4912,102
2011,OX3  9,OX3  9,Total,3807,3679,128
2011,OX33 1,OX33 1,Total,3270,3146,124
2011,OX39 4,OX39 4,Total,2810,2734,76
2011,OX4  1,OX4  1,Total,4977,4692,285
2011,OX4  2,OX4  2,Total,3916,3818,98
2011,OX4  3,OX4  3,Total,4792,4678,114
2011,OX4  4,OX4  4,Total,5499,5337,162
2011,OX4  6,OX4  6,Total,3044,3005,39
2011,OX4  7,OX4  7,Total,2228,2210,18
2011,OX44 7,OX44 7,Total,2234,2117,117
2011,OX44 9,OX44 9,Total,1240,1169,71
2011,OX49 5,OX49 5,Total,1903,1789,114
2011,OX5  1,OX5  1,Total,5022,4822,200
2011,OX5  2,OX5  2,Total,3646,3508,138
2011,OX5  3,OX5  3,Total,1249,1187,62
2011,OX7  3,OX7  3,Total,2515,2336,179
2011,OX7  4,OX7  4,Total,674,579,95
2011,OX7  5,OX7  5,Total,3749,3478,271
2011,OX7  6,OX7  6,Total,2964,2602,362
2011,OX7  7,OX7  7,Total,870,816,54
2011,OX9  2,OX9  2,Total,1545,1484,61
2011,OX9  3,OX9  3,Total,3822,3698,124
2011,OX9  7,OX9  7,Total,436,409,27
2011,PE1  1,PE1  1,Total,442,399,43
2011,PE1  2,PE1  2,Total,3776,3457,319
2011,PE1  3,PE1  3,Total,5414,5159,255
2011,PE1  4,PE1  4,Total,6126,5962,164
2011,PE1  5,PE1  5,Total,3686,3501,185
2011,PE10 0,PE10 0,Total,4141,4009,132
2011,PE10 9,PE10 9,Total,5272,5074,198
2011,PE11 1,PE11 1,Total,3725,3601,124
2011,PE11 2,PE11 2,Total,5670,5510,160
2011,PE11 3,PE11 3,Total,5665,5510,155
2011,PE11 4,PE11 4,Total,3652,3523,129
2011,PE12 0,PE12 0,Total,2715,2581,134
2011,PE12 6,PE12 6,Total,3963,3854,109
2011,PE12 7,PE12 7,Total,3783,3619,164
2011,PE12 8,PE12 8,Total,1965,1867,98
2011,PE12 9,PE12 9,Total,5270,5003,267
2011,PE13 1,PE13 1,Total,1500,1364,136
2011,PE13 2,PE13 2,Total,3754,3657,97
2011,PE13 3,PE13 3,Total,4636,4476,160
2011,PE13 4,PE13 4,Total,2880,2755,125
2011,PE13 5,PE13 5,Total,2595,2510,85
2011,PE14 0,PE14 0,Total,2414,2331,83
2011,PE14 7,PE14 7,Total,2443,2316,127
2011,PE14 8,PE14 8,Total,2356,2191,165
2011,PE14 9,PE14 9,Total,1906,1739,167
2011,PE15 0,PE15 0,Total,3800,3647,153
2011,PE15 8,PE15 8,Total,4641,4521,120
2011,PE15 9,PE15 9,Total,4720,4589,131
2011,PE16 6,PE16 6,Total,4732,4537,195
2011,PE19 1,PE19 1,Total,2975,2913,62
2011,PE19 2,PE19 2,Total,4302,4206,96
2011,PE19 5,PE19 5,Total,2899,2836,63
2011,PE19 6,PE19 6,Total,3270,3173,97
2011,PE19 7,PE19 7,Total,2253,2207,46
2011,PE19 8,PE19 8,Total,3153,3096,57
2011,PE2  5,PE2  5,Total,6503,6302,201
2011,PE2  6,PE2  6,Total,1142,1128,14
2011,PE2  7,PE2  7,Total,1444,1409,35
2011,PE2  8,PE2  8,Total,6093,5879,214
2011,PE2  9,PE2  9,Total,4496,4366,130
2011,PE20 1,PE20 1,Total,2911,2802,109
2011,PE20 2,PE20 2,Total,1320,1278,42
2011,PE20 3,PE20 3,Total,1922,1854,68
2011,PE21 0,PE21 0,Total,4282,4179,103
2011,PE21 6,PE21 6,Total,1521,1422,99
2011,PE21 7,PE21 7,Total,3813,3709,104
2011,PE21 8,PE21 8,Total,5307,5057,250
2011,PE21 9,PE21 9,Total,3948,3835,113
2011,PE22 0,PE22 0,Total,2612,2489,123
2011,PE22 7,PE22 7,Total,1592,1488,104
2011,PE22 8,PE22 8,Total,1712,1644,68
2011,PE22 9,PE22 9,Total,1507,1418,89
2011,PE23 4,PE23 4,Total,1186,1116,70
2011,PE23 5,PE23 5,Total,2794,2618,176
2011,PE24 4,PE24 4,Total,1892,1759,133
2011,PE24 5,PE24 5,Total,4106,3693,413
2011,PE25 1,PE25 1,Total,3474,3229,245
2011,PE25 2,PE25 2,Total,4525,4123,402
2011,PE25 3,PE25 3,Total,2801,2490,311
2011,PE26 1,PE26 1,Total,2589,2459,130
2011,PE26 2,PE26 2,Total,2523,2442,81
2011,PE27 3,PE27 3,Total,3175,3115,60
2011,PE27 4,PE27 4,Total,1024,1007,17
2011,PE27 5,PE27 5,Total,2568,2474,94
2011,PE27 6,PE27 6,Total,1934,1904,30
2011,PE28 0,PE28 0,Total,2292,2204,88
2011,PE28 2,PE28 2,Total,3948,3711,237
2011,PE28 3,PE28 3,Total,3957,3851,106
2011,PE28 4,PE28 4,Total,3544,3431,113
2011,PE28 5,PE28 5,Total,3117,3011,106
2011,PE28 9,PE28 9,Total,2738,2665,73
2011,PE29 1,PE29 1,Total,4806,4718,88
2011,PE29 2,PE29 2,Total,2943,2879,64
2011,PE29 3,PE29 3,Total,1092,1002,90
2011,PE29 6,PE29 6,Total,2129,2069,60
2011,PE29 7,PE29 7,Total,1390,1362,28
2011,PE3  6,PE3  6,Total,2426,2367,59
2011,PE3  7,PE3  7,Total,2468,2413,55
2011,PE3  8,PE3  8,Total,2867,2728,139
2011,PE3  9,PE3  9,Total,3960,3895,65
2011,PE30 1,PE30 1,Total,1245,1021,224
2011,PE30 2,PE30 2,Total,3080,2814,266
2011,PE30 3,PE30 3,Total,5921,5794,127
2011,PE30 4,PE30 4,Total,5426,5152,274
2011,PE30 5,PE30 5,Total,3796,3437,359
2011,PE31 6,PE31 6,Total,4067,3712,355
2011,PE31 7,PE31 7,Total,6566,3553,3013
2011,PE31 8,PE31 8,Total,3586,2268,1318
2011,PE32 1,PE32 1,Total,4141,3878,263
2011,PE32 2,PE32 2,Total,3000,2719,281
2011,PE33 0,PE33 0,Total,3419,3255,164
2011,PE33 9,PE33 9,Total,3222,2963,259
2011,PE34 3,PE34 3,Total,2340,2233,107
2011,PE34 4,PE34 4,Total,3901,3695,206
2011,PE36 5,PE36 5,Total,3413,1818,1595
2011,PE36 6,PE36 6,Total,2481,1381,1100
2011,PE37 7,PE37 7,Total,3268,3074,194
2011,PE37 8,PE37 8,Total,1644,1538,106
2011,PE38 0,PE38 0,Total,2145,1945,200
2011,PE38 9,PE38 9,Total,4883,4637,246
2011,PE4  5,PE4  5,Total,2580,2518,62
2011,PE4  6,PE4  6,Total,5053,4925,128
2011,PE4  7,PE4  7,Total,4960,4817,143
2011,PE5  7,PE5  7,Total,691,675,16
2011,PE6  0,PE6  0,Total,2870,2753,117
2011,PE6  7,PE6  7,Total,4035,3891,144
2011,PE6  8,PE6  8,Total,5689,5555,134
2011,PE6  9,PE6  9,Total,2615,2542,73
2011,PE7  0,PE7  0,Total,69,69,0
2011,PE7  1,PE7  1,Total,5764,5561,203
2011,PE7  2,PE7  2,Total,1211,1162,49
2011,PE7  3,PE7  3,Total,6712,6531,181
2011,PE7  8,PE7  8,Total,4009,3903,106
2011,PE8  4,PE8  4,Total,2235,2127,108
2011,PE8  5,PE8  5,Total,1569,1462,107
2011,PE8  6,PE8  6,Total,3450,3145,305
2011,PE9  1,PE9  1,Total,4370,4246,124
2011,PE9  2,PE9  2,Total,4759,4499,260
2011,PE9  3,PE9  3,Total,2703,2559,144
2011,PE9  4,PE9  4,Total,2549,2460,89
2011,PL1  1,PL1  1,Total,396,349,47
2011,PL1  2,PL1  2,Total,1432,1323,109
2011,PL1  3,PL1  3,Total,3084,2867,217
2011,PL1  4,PL1  4,Total,2751,2638,113
2011,PL1  5,PL1  5,Total,4420,4228,192
2011,PL10 1,PL10 1,Total,2166,1664,502
2011,PL11 2,PL11 2,Total,3614,3475,139
2011,PL11 3,PL11 3,Total,1341,1108,233
2011,PL12 4,PL12 4,Total,4681,4553,128
2011,PL12 5,PL12 5,Total,1091,1023,68
2011,PL12 6,PL12 6,Total,3963,3808,155
2011,PL13 1,PL13 1,Total,2452,1972,480
2011,PL13 2,PL13 2,Total,2994,2428,566
2011,PL14 3,PL14 3,Total,3754,3587,167
2011,PL14 4,PL14 4,Total,2644,2442,202
2011,PL14 5,PL14 5,Total,2647,2441,206
2011,PL14 6,PL14 6,Total,1674,1563,111
2011,PL15 7,PL15 7,Total,2888,2685,203
2011,PL15 8,PL15 8,Total,3248,2990,258
2011,PL15 9,PL15 9,Total,2896,2692,204
2011,PL16 0,PL16 0,Total,795,717,78
2011,PL17 7,PL17 7,Total,2661,2520,141
2011,PL17 8,PL17 8,Total,1880,1757,123
2011,PL18 9,PL18 9,Total,2262,2122,140
2011,PL19 0,PL19 0,Total,1445,1285,160
2011,PL19 8,PL19 8,Total,2836,2677,159
2011,PL19 9,PL19 9,Total,3359,3183,176
2011,PL2  1,PL2  1,Total,5012,4754,258
2011,PL2  2,PL2  2,Total,4405,4208,197
2011,PL2  3,PL2  3,Total,4703,4561,142
2011,PL20 6,PL20 6,Total,2220,2071,149
2011,PL20 7,PL20 7,Total,3166,2923,243
2011,PL21 0,PL21 0,Total,4029,3838,191
2011,PL21 9,PL21 9,Total,3394,3259,135
2011,PL22 0,PL22 0,Total,1808,1626,182
2011,PL23 1,PL23 1,Total,2426,1668,758
2011,PL24 2,PL24 2,Total,4461,4224,237
2011,PL25 3,PL25 3,Total,5072,4679,393
2011,PL25 4,PL25 4,Total,3926,3762,164
2011,PL25 5,PL25 5,Total,2578,2458,120
2011,PL26 6,PL26 6,Total,2977,2258,719
2011,PL26 7,PL26 7,Total,4197,3994,203
2011,PL26 8,PL26 8,Total,5163,4844,319
2011,PL27 6,PL27 6,Total,3478,2329,1149
2011,PL27 7,PL27 7,Total,3509,2937,572
2011,PL28 8,PL28 8,Total,3366,1965,1401
2011,PL29 3,PL29 3,Total,863,479,384
2011,PL3  4,PL3  4,Total,4198,3986,212
2011,PL3  5,PL3  5,Total,3902,3751,151
2011,PL3  6,PL3  6,Total,5358,5212,146
2011,PL30 3,PL30 3,Total,1835,1510,325
2011,PL30 4,PL30 4,Total,1317,1127,190
2011,PL30 5,PL30 5,Total,1991,1786,205
2011,PL31 1,PL31 1,Total,3582,3455,127
2011,PL31 2,PL31 2,Total,2903,2791,112
2011,PL32 9,PL32 9,Total,2056,1779,277
2011,PL33 9,PL33 9,Total,806,722,84
2011,PL34 0,PL34 0,Total,1073,817,256
2011,PL35 0,PL35 0,Total,664,454,210
2011,PL4  0,PL4  0,Total,1565,1456,109
2011,PL4  6,PL4  6,Total,2437,2323,114
2011,PL4  7,PL4  7,Total,3835,3576,259
2011,PL4  8,PL4  8,Total,3994,3759,235
2011,PL4  9,PL4  9,Total,3763,3537,226
2011,PL5  1,PL5  1,Total,5340,5157,183
2011,PL5  2,PL5  2,Total,4375,4246,129
2011,PL5  3,PL5  3,Total,4993,4828,165
2011,PL5  4,PL5  4,Total,4265,4153,112
2011,PL6  5,PL6  5,Total,5597,5477,120
2011,PL6  6,PL6  6,Total,4110,4034,76
2011,PL6  7,PL6  7,Total,3576,3459,117
2011,PL6  8,PL6  8,Total,4269,4166,103
2011,PL7  1,PL7  1,Total,3830,3732,98
2011,PL7  2,PL7  2,Total,4537,4437,100
2011,PL7  4,PL7  4,Total,3781,3717,64
2011,PL7  5,PL7  5,Total,1082,1047,35
2011,PL8  1,PL8  1,Total,1362,1118,244
2011,PL8  2,PL8  2,Total,1542,1454,88
2011,PL9  0,PL9  0,Total,1439,1285,154
2011,PL9  7,PL9  7,Total,2240,2169,71
2011,PL9  8,PL9  8,Total,3538,3452,86
2011,PL9  9,PL9  9,Total,5251,5124,127
2011,PO1  1,PO1  1,Total,2063,2016,47
2011,PO1  2,PO1  2,Total,1545,1400,145
2011,PO1  3,PO1  3,Total,2904,2635,269
2011,PO1  4,PO1  4,Total,2209,2180,29
2011,PO1  5,PO1  5,Total,4305,4177,128
2011,PO10 7,PO10 7,Total,4500,4329,171
2011,PO10 8,PO10 8,Total,3807,3640,167
2011,PO11 0,PO11 0,Total,3681,3497,184
2011,PO11 9,PO11 9,Total,4802,4462,340
2011,PO12 1,PO12 1,Total,4600,4258,342
2011,PO12 2,PO12 2,Total,4321,4183,138
2011,PO12 3,PO12 3,Total,5539,5394,145
2011,PO12 4,PO12 4,Total,7551,7336,215
2011,PO13 0,PO13 0,Total,6937,6788,149
2011,PO13 8,PO13 8,Total,2814,2778,36
2011,PO13 9,PO13 9,Total,4950,4693,257
2011,PO14 1,PO14 1,Total,3370,3289,81
2011,PO14 2,PO14 2,Total,3429,3359,70
2011,PO14 3,PO14 3,Total,3682,3510,172
2011,PO14 4,PO14 4,Total,3640,3400,240
2011,PO15 5,PO15 5,Total,3303,3243,60
2011,PO15 6,PO15 6,Total,3473,3416,57
2011,PO15 7,PO15 7,Total,2859,2730,129
2011,PO16 0,PO16 0,Total,2621,2515,106
2011,PO16 7,PO16 7,Total,3272,3194,78
2011,PO16 8,PO16 8,Total,4640,4550,90
2011,PO16 9,PO16 9,Total,3835,3752,83
2011,PO17 5,PO17 5,Total,2096,2013,83
2011,PO17 6,PO17 6,Total,709,674,35
2011,PO18 0,PO18 0,Total,2139,2006,133
2011,PO18 8,PO18 8,Total,3130,2854,276
2011,PO18 9,PO18 9,Total,801,728,73
2011,PO19 1,PO19 1,Total,990,823,167
2011,PO19 3,PO19 3,Total,2979,2887,92
2011,PO19 5,PO19 5,Total,1137,1095,42
2011,PO19 6,PO19 6,Total,3061,2923,138
2011,PO19 7,PO19 7,Total,3803,3666,137
2011,PO19 8,PO19 8,Total,2529,2401,128
2011,PO2  0,PO2  0,Total,5323,5208,115
2011,PO2  7,PO2  7,Total,5437,5285,152
2011,PO2  8,PO2  8,Total,3661,3515,146
2011,PO2  9,PO2  9,Total,3426,3350,76
2011,PO20 0,PO20 0,Total,4248,3942,306
2011,PO20 1,PO20 1,Total,1100,1049,51
2011,PO20 2,PO20 2,Total,1579,1499,80
2011,PO20 3,PO20 3,Total,2022,1790,232
2011,PO20 7,PO20 7,Total,1764,1501,263
2011,PO20 8,PO20 8,Total,4151,3435,716
2011,PO20 9,PO20 9,Total,1066,921,145
2011,PO21 1,PO21 1,Total,3092,2810,282
2011,PO21 2,PO21 2,Total,4614,4239,375
2011,PO21 3,PO21 3,Total,3850,3694,156
2011,PO21 4,PO21 4,Total,3749,3518,231
2011,PO21 5,PO21 5,Total,3831,3714,117
2011,PO22 0,PO22 0,Total,1630,1577,53
2011,PO22 6,PO22 6,Total,2818,2670,148
2011,PO22 7,PO22 7,Total,2882,2614,268
2011,PO22 8,PO22 8,Total,2533,2447,86
2011,PO22 9,PO22 9,Total,3392,3280,112
2011,PO3  5,PO3  5,Total,3243,3174,69
2011,PO3  6,PO3  6,Total,4742,4638,104
2011,PO30 1,PO30 1,Total,3243,3087,156
2011,PO30 2,PO30 2,Total,2373,2321,52
2011,PO30 3,PO30 3,Total,1053,970,83
2011,PO30 4,PO30 4,Total,1611,1431,180
2011,PO30 5,PO30 5,Total,4672,4495,177
2011,PO31 7,PO31 7,Total,4399,3831,568
2011,PO31 8,PO31 8,Total,2968,2640,328
2011,PO32 6,PO32 6,Total,3840,3561,279
2011,PO33 1,PO33 1,Total,4261,3910,351
2011,PO33 2,PO33 2,Total,4020,3679,341
2011,PO33 3,PO33 3,Total,4181,4040,141
2011,PO33 4,PO33 4,Total,2440,2305,135
2011,PO34 5,PO34 5,Total,1605,1075,530
2011,PO35 5,PO35 5,Total,2116,1703,413
2011,PO36 0,PO36 0,Total,2180,2042,138
2011,PO36 8,PO36 8,Total,2613,2314,299
2011,PO36 9,PO36 9,Total,3238,3107,131
2011,PO37 6,PO37 6,Total,1852,1560,292
2011,PO37 7,PO37 7,Total,2685,2520,165
2011,PO38 1,PO38 1,Total,3579,2846,733
2011,PO38 2,PO38 2,Total,1396,1227,169
2011,PO38 3,PO38 3,Total,1796,1684,112
2011,PO39 0,PO39 0,Total,1411,1173,238
2011,PO4  0,PO4  0,Total,5882,5611,271
2011,PO4  8,PO4  8,Total,6026,5889,137
2011,PO4  9,PO4  9,Total,6970,6691,279
2011,PO40 9,PO40 9,Total,2932,2593,339
2011,PO41 0,PO41 0,Total,1212,971,241
2011,PO5  1,PO5  1,Total,4122,3934,188
2011,PO5  2,PO5  2,Total,3829,3585,244
2011,PO5  3,PO5  3,Total,2994,2793,201
2011,PO5  4,PO5  4,Total,3023,2942,81
2011,PO6  1,PO6  1,Total,3543,3457,86
2011,PO6  2,PO6  2,Total,4613,4508,105
2011,PO6  3,PO6  3,Total,4031,3949,82
2011,PO6  4,PO6  4,Total,4608,4398,210
2011,PO7  4,PO7  4,Total,562,494,68
2011,PO7  5,PO7  5,Total,4642,4545,97
2011,PO7  6,PO7  6,Total,4392,4269,123
2011,PO7  7,PO7  7,Total,3848,3761,87
2011,PO7  8,PO7  8,Total,3902,3842,60
2011,PO8  0,PO8  0,Total,4035,3920,115
2011,PO8  8,PO8  8,Total,3971,3899,72
2011,PO8  9,PO8  9,Total,6178,6073,105
2011,PO9  1,PO9  1,Total,2653,2502,151
2011,PO9  2,PO9  2,Total,4429,4357,72
2011,PO9  3,PO9  3,Total,4118,4049,69
2011,PO9  4,PO9  4,Total,4000,3928,72
2011,PO9  5,PO9  5,Total,4024,3961,63
2011,PO9  6,PO9  6,Total,1305,1275,30
2011,PR1  0,PR1  0,Total,4044,3921,123
2011,PR1  1,PR1  1,Total,1556,1473,83
2011,PR1  2,PR1  2,Total,581,483,98
2011,PR1  3,PR1  3,Total,1902,1741,161
2011,PR1  4,PR1  4,Total,3610,3442,168
2011,PR1  5,PR1  5,Total,3956,3636,320
2011,PR1  6,PR1  6,Total,4124,3933,191
2011,PR1  7,PR1  7,Total,2616,2375,241
2011,PR1  8,PR1  8,Total,2884,2605,279
2011,PR1  9,PR1  9,Total,5629,5427,202
2011,PR2  1,PR2  1,Total,6588,6356,232
2011,PR2  2,PR2  2,Total,4140,3825,315
2011,PR2  3,PR2  3,Total,6799,6568,231
2011,PR2  5,PR2  5,Total,1140,1112,28
2011,PR2  6,PR2  6,Total,6518,6337,181
2011,PR2  7,PR2  7,Total,1860,1818,42
2011,PR2  8,PR2  8,Total,3041,2911,130
2011,PR2  9,PR2  9,Total,4635,4522,113
2011,PR25 1,PR25 1,Total,3730,3627,103
2011,PR25 2,PR25 2,Total,2397,2303,94
2011,PR25 3,PR25 3,Total,2863,2788,75
2011,PR25 4,PR25 4,Total,2681,2601,80
2011,PR25 5,PR25 5,Total,1803,1776,27
2011,PR26 6,PR26 6,Total,1145,1119,26
2011,PR26 7,PR26 7,Total,2676,2620,56
2011,PR26 8,PR26 8,Total,358,332,26
2011,PR26 9,PR26 9,Total,1564,1504,60
2011,PR3  0,PR3  0,Total,3119,2927,192
2011,PR3  1,PR3  1,Total,4779,4541,238
2011,PR3  2,PR3  2,Total,2260,2163,97
2011,PR3  3,PR3  3,Total,3977,3819,158
2011,PR3  5,PR3  5,Total,1302,1239,63
2011,PR3  6,PR3  6,Total,1098,1043,55
2011,PR4  0,PR4  0,Total,2854,2782,72
2011,PR4  1,PR4  1,Total,4427,4227,200
2011,PR4  2,PR4  2,Total,3702,3546,156
2011,PR4  3,PR4  3,Total,3608,3393,215
2011,PR4  4,PR4  4,Total,2564,2470,94
2011,PR4  5,PR4  5,Total,3666,3535,131
2011,PR4  6,PR4  6,Total,4330,3981,349
2011,PR5  0,PR5  0,Total,2472,2353,119
2011,PR5  4,PR5  4,Total,4918,4754,164
2011,PR5  5,PR5  5,Total,4406,4270,136
2011,PR5  6,PR5  6,Total,4070,3917,153
2011,PR5  8,PR5  8,Total,2261,2217,44
2011,PR6  0,PR6  0,Total,4675,4475,200
2011,PR6  7,PR6  7,Total,4428,4299,129
2011,PR6  8,PR6  8,Total,2924,2811,113
2011,PR6  9,PR6  9,Total,3329,3224,105
2011,PR7  1,PR7  1,Total,3179,3059,120
2011,PR7  2,PR7  2,Total,4416,4247,169
2011,PR7  3,PR7  3,Total,3952,3671,281
2011,PR7  4,PR7  4,Total,3034,2911,123
2011,PR7  5,PR7  5,Total,4567,4414,153
2011,PR7  6,PR7  6,Total,3697,3609,88
2011,PR7  7,PR7  7,Total,2062,1812,250
2011,PR8  1,PR8  1,Total,1919,1600,319
2011,PR8  2,PR8  2,Total,4379,4088,291
2011,PR8  3,PR8  3,Total,5428,5263,165
2011,PR8  4,PR8  4,Total,4798,4610,188
2011,PR8  5,PR8  5,Total,2758,2592,166
2011,PR8  6,PR8  6,Total,5135,4868,267
2011,PR9  0,PR9  0,Total,4618,3759,859
2011,PR9  7,PR9  7,Total,4821,4668,153
2011,PR9  8,PR9  8,Total,4760,4419,341
2011,PR9  9,PR9  9,Total,7144,6726,418
2011,RG1  1,RG1  1,Total,269,245,24
2011,RG1  2,RG1  2,Total,1846,1749,97
2011,RG1  3,RG1  3,Total,2971,2821,150
2011,RG1  4,RG1  4,Total,1481,1386,95
2011,RG1  5,RG1  5,Total,3489,3324,165
2011,RG1  6,RG1  6,Total,4094,3927,167
2011,RG1  7,RG1  7,Total,3836,3488,348
2011,RG1  8,RG1  8,Total,1223,1163,60
2011,RG10 0,RG10 0,Total,2397,2315,82
2011,RG10 8,RG10 8,Total,1621,1512,109
2011,RG10 9,RG10 9,Total,3731,3603,128
2011,RG12 0,RG12 0,Total,3286,3241,45
2011,RG12 2,RG12 2,Total,2341,2304,37
2011,RG12 7,RG12 7,Total,7578,7398,180
2011,RG12 8,RG12 8,Total,4365,4288,77
2011,RG12 9,RG12 9,Total,4691,4570,121
2011,RG14 1,RG14 1,Total,3165,3021,144
2011,RG14 2,RG14 2,Total,3483,3399,84
2011,RG14 3,RG14 3,Total,314,288,26
2011,RG14 5,RG14 5,Total,2273,2143,130
2011,RG14 6,RG14 6,Total,3562,3485,77
2011,RG14 7,RG14 7,Total,4201,4039,162
2011,RG17 0,RG17 0,Total,2928,2758,170
2011,RG17 7,RG17 7,Total,1100,1046,54
2011,RG17 8,RG17 8,Total,1472,1370,102
2011,RG17 9,RG17 9,Total,1490,1396,94
2011,RG18 0,RG18 0,Total,499,469,30
2011,RG18 3,RG18 3,Total,2660,2619,41
2011,RG18 4,RG18 4,Total,1804,1779,25
2011,RG18 9,RG18 9,Total,2177,2100,77
2011,RG19 3,RG19 3,Total,3087,3033,54
2011,RG19 4,RG19 4,Total,2946,2890,56
2011,RG19 8,RG19 8,Total,1276,1199,77
2011,RG2  0,RG2  0,Total,2673,2351,322
2011,RG2  7,RG2  7,Total,4207,4048,159
2011,RG2  8,RG2  8,Total,4882,4719,163
2011,RG2  9,RG2  9,Total,3297,3070,227
2011,RG20 0,RG20 0,Total,934,866,68
2011,RG20 4,RG20 4,Total,402,388,14
2011,RG20 5,RG20 5,Total,1458,1417,41
2011,RG20 6,RG20 6,Total,624,602,22
2011,RG20 7,RG20 7,Total,869,798,71
2011,RG20 8,RG20 8,Total,1523,1447,76
2011,RG20 9,RG20 9,Total,1963,1919,44
2011,RG21 3,RG21 3,Total,3566,3436,130
2011,RG21 4,RG21 4,Total,1389,1363,26
2011,RG21 5,RG21 5,Total,3165,3105,60
2011,RG21 6,RG21 6,Total,282,252,30
2011,RG21 7,RG21 7,Total,1947,1793,154
2011,RG21 8,RG21 8,Total,1832,1763,69
2011,RG22 4,RG22 4,Total,8294,8185,109
2011,RG22 5,RG22 5,Total,4156,4085,71
2011,RG22 6,RG22 6,Total,4698,4637,61
2011,RG23 7,RG23 7,Total,2242,2198,44
2011,RG23 8,RG23 8,Total,2872,2821,51
2011,RG24 7,RG24 7,Total,1732,1697,35
2011,RG24 8,RG24 8,Total,4764,4688,76
2011,RG24 9,RG24 9,Total,6604,6470,134
2011,RG25 2,RG25 2,Total,1797,1724,73
2011,RG25 3,RG25 3,Total,1972,1944,28
2011,RG26 3,RG26 3,Total,3638,3563,75
2011,RG26 4,RG26 4,Total,1951,1905,46
2011,RG26 5,RG26 5,Total,3702,3632,70
2011,RG27 0,RG27 0,Total,2309,2221,88
2011,RG27 8,RG27 8,Total,2848,2728,120
2011,RG27 9,RG27 9,Total,3592,3471,121
2011,RG28 7,RG28 7,Total,2524,2467,57
2011,RG29 1,RG29 1,Total,2616,2459,157
2011,RG30 1,RG30 1,Total,2023,1946,77
2011,RG30 2,RG30 2,Total,5691,5440,251
2011,RG30 3,RG30 3,Total,3521,3425,96
2011,RG30 4,RG30 4,Total,5159,4944,215
2011,RG30 6,RG30 6,Total,2441,2381,60
2011,RG31 4,RG31 4,Total,1843,1808,35
2011,RG31 5,RG31 5,Total,2646,2608,38
2011,RG31 6,RG31 6,Total,3869,3793,76
2011,RG31 7,RG31 7,Total,2697,2657,40
2011,RG4  5,RG4  5,Total,2870,2773,97
2011,RG4  6,RG4  6,Total,2840,2763,77
2011,RG4  7,RG4  7,Total,3635,3475,160
2011,RG4  8,RG4  8,Total,4704,4504,200
2011,RG4  9,RG4  9,Total,2399,2309,90
2011,RG40 1,RG40 1,Total,3684,3418,266
2011,RG40 2,RG40 2,Total,2082,1987,95
2011,RG40 3,RG40 3,Total,1782,1703,79
2011,RG40 4,RG40 4,Total,3063,2958,105
2011,RG40 5,RG40 5,Total,729,701,28
2011,RG41 1,RG41 1,Total,1515,1489,26
2011,RG41 2,RG41 2,Total,2025,1966,59
2011,RG41 3,RG41 3,Total,2553,2506,47
2011,RG41 4,RG41 4,Total,1465,1426,39
2011,RG41 5,RG41 5,Total,3581,3466,115
2011,RG42 1,RG42 1,Total,2079,2013,66
2011,RG42 2,RG42 2,Total,2647,2609,38
2011,RG42 3,RG42 3,Total,2424,2393,31
2011,RG42 4,RG42 4,Total,1785,1736,49
2011,RG42 5,RG42 5,Total,685,665,20
2011,RG42 6,RG42 6,Total,598,576,22
2011,RG42 7,RG42 7,Total,661,648,13
2011,RG45 6,RG45 6,Total,3524,3382,142
2011,RG45 7,RG45 7,Total,2194,2087,107
2011,RG5  3,RG5  3,Total,4527,4408,119
2011,RG5  4,RG5  4,Total,5670,5566,104
2011,RG6  1,RG6  1,Total,2882,2795,87
2011,RG6  3,RG6  3,Total,2337,2304,33
2011,RG6  4,RG6  4,Total,3254,3188,66
2011,RG6  5,RG6  5,Total,2512,2452,60
2011,RG6  6,RG6  6,Total,52,50,2
2011,RG6  7,RG6  7,Total,2949,2862,87
2011,RG7  1,RG7  1,Total,2773,2669,104
2011,RG7  2,RG7  2,Total,846,809,37
2011,RG7  3,RG7  3,Total,4126,3995,131
2011,RG7  4,RG7  4,Total,1358,1260,98
2011,RG7  5,RG7  5,Total,2455,2363,92
2011,RG7  6,RG7  6,Total,1620,1538,82
2011,RG8  0,RG8  0,Total,2225,2098,127
2011,RG8  7,RG8  7,Total,2004,1902,102
2011,RG8  8,RG8  8,Total,2258,2191,67
2011,RG8  9,RG8  9,Total,1390,1295,95
2011,RG9  1,RG9  1,Total,4263,3977,286
2011,RG9  2,RG9  2,Total,1424,1280,144
2011,RG9  3,RG9  3,Total,858,767,91
2011,RG9  4,RG9  4,Total,800,742,58
2011,RG9  5,RG9  5,Total,1637,1514,123
2011,RG9  6,RG9  6,Total,1426,1314,112
2011,RH1  1,RH1  1,Total,2541,2365,176
2011,RH1  2,RH1  2,Total,3168,3015,153
2011,RH1  3,RH1  3,Total,3492,3398,94
2011,RH1  4,RH1  4,Total,2481,2408,73
2011,RH1  5,RH1  5,Total,3358,3251,107
2011,RH1  6,RH1  6,Total,4675,4504,171
2011,RH10 1,RH10 1,Total,2993,2902,91
2011,RH10 3,RH10 3,Total,4831,4736,95
2011,RH10 4,RH10 4,Total,2845,2781,64
2011,RH10 5,RH10 5,Total,2485,2454,31
2011,RH10 6,RH10 6,Total,4044,3980,64
2011,RH10 7,RH10 7,Total,7208,7097,111
2011,RH10 8,RH10 8,Total,2624,2564,60
2011,RH11 0,RH11 0,Total,3968,3893,75
2011,RH11 6,RH11 6,Total,1117,1104,13
2011,RH11 7,RH11 7,Total,5148,5054,94
2011,RH11 8,RH11 8,Total,6255,6141,114
2011,RH11 9,RH11 9,Total,5711,5625,86
2011,RH12 1,RH12 1,Total,3471,3346,125
2011,RH12 2,RH12 2,Total,3478,3403,75
2011,RH12 3,RH12 3,Total,3658,3539,119
2011,RH12 4,RH12 4,Total,4238,4152,86
2011,RH12 5,RH12 5,Total,4015,3961,54
2011,RH13 0,RH13 0,Total,1764,1694,70
2011,RH13 5,RH13 5,Total,4034,3946,88
2011,RH13 6,RH13 6,Total,3699,3582,117
2011,RH13 8,RH13 8,Total,2647,2553,94
2011,RH13 9,RH13 9,Total,3519,3467,52
2011,RH14 0,RH14 0,Total,2527,2387,140
2011,RH14 9,RH14 9,Total,3576,3452,124
2011,RH15 0,RH15 0,Total,4609,4359,250
2011,RH15 8,RH15 8,Total,4839,4767,72
2011,RH15 9,RH15 9,Total,3601,3536,65
2011,RH16 1,RH16 1,Total,3104,3043,61
2011,RH16 2,RH16 2,Total,3171,3066,105
2011,RH16 3,RH16 3,Total,4476,4388,88
2011,RH16 4,RH16 4,Total,3930,3871,59
2011,RH17 5,RH17 5,Total,2747,2668,79
2011,RH17 6,RH17 6,Total,2206,2114,92
2011,RH17 7,RH17 7,Total,2795,2703,92
2011,RH18 5,RH18 5,Total,1918,1848,70
2011,RH19 1,RH19 1,Total,3205,3112,93
2011,RH19 2,RH19 2,Total,2877,2800,77
2011,RH19 3,RH19 3,Total,4657,4543,114
2011,RH19 4,RH19 4,Total,3424,3304,120
2011,RH2  0,RH2  0,Total,3255,3104,151
2011,RH2  7,RH2  7,Total,2869,2822,47
2011,RH2  8,RH2  8,Total,2934,2876,58
2011,RH2  9,RH2  9,Total,1811,1746,65
2011,RH20 1,RH20 1,Total,2362,2202,160
2011,RH20 2,RH20 2,Total,3131,3034,97
2011,RH20 3,RH20 3,Total,2676,2598,78
2011,RH20 4,RH20 4,Total,3100,2990,110
2011,RH3  7,RH3  7,Total,1853,1800,53
2011,RH4  1,RH4  1,Total,2412,2333,79
2011,RH4  2,RH4  2,Total,2262,2190,72
2011,RH4  3,RH4  3,Total,2303,2220,83
2011,RH5  4,RH5  4,Total,3101,3022,79
2011,RH5  5,RH5  5,Total,2229,2165,64
2011,RH5  6,RH5  6,Total,1538,1454,84
2011,RH6  0,RH6  0,Total,1067,1037,30
2011,RH6  7,RH6  7,Total,2663,2572,91
2011,RH6  8,RH6  8,Total,3704,3646,58
2011,RH6  9,RH6  9,Total,4989,4778,211
2011,RH7  6,RH7  6,Total,3812,3615,197
2011,RH8  0,RH8  0,Total,3942,3816,126
2011,RH8  9,RH8  9,Total,2386,2302,84
2011,RH9  8,RH9  8,Total,2281,2185,96
2011,RM1  1,RM1  1,Total,898,848,50
2011,RM1  2,RM1  2,Total,2023,1970,53
2011,RM1  3,RM1  3,Total,1003,968,35
2011,RM1  4,RM1  4,Total,4788,4679,109
2011,RM10 7,RM10 7,Total,4376,4253,123
2011,RM10 8,RM10 8,Total,5935,5820,115
2011,RM10 9,RM10 9,Total,4779,4635,144
2011,RM11 1,RM11 1,Total,4621,4546,75
2011,RM11 2,RM11 2,Total,3876,3796,80
2011,RM11 3,RM11 3,Total,4268,4188,80
2011,RM12 4,RM12 4,Total,6635,6501,134
2011,RM12 5,RM12 5,Total,3966,3910,56
2011,RM12 6,RM12 6,Total,3692,3621,71
2011,RM13 7,RM13 7,Total,3724,3657,67
2011,RM13 8,RM13 8,Total,3150,3035,115
2011,RM13 9,RM13 9,Total,5092,4995,97
2011,RM14 1,RM14 1,Total,4735,4644,91
2011,RM14 2,RM14 2,Total,3517,3425,92
2011,RM14 3,RM14 3,Total,2906,2826,80
2011,RM15 4,RM15 4,Total,3305,3234,71
2011,RM15 5,RM15 5,Total,4687,4589,98
2011,RM15 6,RM15 6,Total,3409,3320,89
2011,RM16 2,RM16 2,Total,4936,4845,91
2011,RM16 3,RM16 3,Total,1433,1394,39
2011,RM16 4,RM16 4,Total,3992,3939,53
2011,RM16 5,RM16 5,Total,267,264,3
2011,RM16 6,RM16 6,Total,5346,5257,89
2011,RM17 5,RM17 5,Total,4919,4814,105
2011,RM17 6,RM17 6,Total,6454,6276,178
2011,RM18 7,RM18 7,Total,1908,1859,49
2011,RM18 8,RM18 8,Total,4539,4448,91
2011,RM19 1,RM19 1,Total,2974,2802,172
2011,RM2  5,RM2  5,Total,2807,2714,93
2011,RM2  6,RM2  6,Total,2945,2894,51
2011,RM20 3,RM20 3,Total,778,718,60
2011,RM20 4,RM20 4,Total,1196,1155,41
2011,RM3  0,RM3  0,Total,4555,4452,103
2011,RM3  7,RM3  7,Total,3875,3805,70
2011,RM3  8,RM3  8,Total,4528,4441,87
2011,RM3  9,RM3  9,Total,4283,4191,92
2011,RM4  1,RM4  1,Total,1890,1781,109
2011,RM5  2,RM5  2,Total,3508,3442,66
2011,RM5  3,RM5  3,Total,3929,3867,62
2011,RM6  4,RM6  4,Total,4307,4230,77
2011,RM6  5,RM6  5,Total,4491,4386,105
2011,RM6  6,RM6  6,Total,3639,3530,109
2011,RM7  0,RM7  0,Total,4281,4191,90
2011,RM7  7,RM7  7,Total,2130,2094,36
2011,RM7  8,RM7  8,Total,3159,3111,48
2011,RM7  9,RM7  9,Total,2357,2299,58
2011,RM8  1,RM8  1,Total,4471,4326,145
2011,RM8  2,RM8  2,Total,6117,5999,118
2011,RM8  3,RM8  3,Total,4611,4546,65
2011,RM9  4,RM9  4,Total,4729,4667,62
2011,RM9  5,RM9  5,Total,4819,4753,66
2011,RM9  6,RM9  6,Total,4312,4248,64
2011,S1   2,S1   2,Total,491,451,40
2011,S1   3,S1   3,Total,54,51,3
2011,S1   4,S1   4,Total,3281,2962,319
2011,S10  1,S10  1,Total,6090,5884,206
2011,S10  2,S10  2,Total,2012,1907,105
2011,S10  3,S10  3,Total,3438,3289,149
2011,S10  4,S10  4,Total,3001,2941,60
2011,S10  5,S10  5,Total,3557,3451,106
2011,S11  7,S11  7,Total,4536,4381,155
2011,S11  8,S11  8,Total,5646,5369,277
2011,S11  9,S11  9,Total,4170,4051,119
2011,S12  2,S12  2,Total,5420,5308,112
2011,S12  3,S12  3,Total,3931,3840,91
2011,S12  4,S12  4,Total,6012,5898,114
2011,S13  7,S13  7,Total,4545,4438,107
2011,S13  8,S13  8,Total,6111,5949,162
2011,S13  9,S13  9,Total,3297,3203,94
2011,S14  1,S14  1,Total,4668,4501,167
2011,S17  3,S17  3,Total,3424,3297,127
2011,S17  4,S17  4,Total,3737,3637,100
2011,S18  1,S18  1,Total,3056,3017,39
2011,S18  2,S18  2,Total,2696,2664,32
2011,S18  3,S18  3,Total,754,745,9
2011,S18  4,S18  4,Total,677,673,4
2011,S18  7,S18  7,Total,883,837,46
2011,S18  8,S18  8,Total,2882,2841,41
2011,S2   1,S2   1,Total,4319,4246,73
2011,S2   2,S2   2,Total,4876,4717,159
2011,S2   3,S2   3,Total,3875,3783,92
2011,S2   4,S2   4,Total,1895,1799,96
2011,S2   5,S2   5,Total,3780,3692,88
2011,S20  1,S20  1,Total,2912,2859,53
2011,S20  2,S20  2,Total,1567,1547,20
2011,S20  3,S20  3,Total,125,123,2
2011,S20  4,S20  4,Total,1852,1815,37
2011,S20  5,S20  5,Total,2363,2320,43
2011,S20  6,S20  6,Total,1154,1131,23
2011,S20  7,S20  7,Total,1934,1900,34
2011,S20  8,S20  8,Total,1874,1833,41
2011,S21  1,S21  1,Total,3275,3250,25
2011,S21  2,S21  2,Total,600,595,5
2011,S21  3,S21  3,Total,1235,1221,14
2011,S21  4,S21  4,Total,3248,3220,28
2011,S21  5,S21  5,Total,539,535,4
2011,S25  1,S25  1,Total,604,574,30
2011,S25  2,S25  2,Total,3767,3612,155
2011,S25  3,S25  3,Total,894,858,36
2011,S25  4,S25  4,Total,2809,2726,83
2011,S25  5,S25  5,Total,1120,1078,42
2011,S26  1,S26  1,Total,729,704,25
2011,S26  2,S26  2,Total,2927,2861,66
2011,S26  3,S26  3,Total,1143,1125,18
2011,S26  4,S26  4,Total,2438,2380,58
2011,S26  5,S26  5,Total,1407,1362,45
2011,S26  6,S26  6,Total,1701,1634,67
2011,S26  7,S26  7,Total,843,822,21
2011,S3   7,S3   7,Total,4180,3912,268
2011,S3   8,S3   8,Total,1474,1345,129
2011,S3   9,S3   9,Total,2115,2025,90
2011,S32  1,S32  1,Total,913,844,69
2011,S32  2,S32  2,Total,427,389,38
2011,S32  3,S32  3,Total,652,608,44
2011,S32  4,S32  4,Total,236,215,21
2011,S32  5,S32  5,Total,490,430,60
2011,S33  0,S33  0,Total,707,655,52
2011,S33  6,S33  6,Total,521,483,38
2011,S33  7,S33  7,Total,153,144,9
2011,S33  8,S33  8,Total,346,295,51
2011,S33  9,S33  9,Total,719,663,56
2011,S35  0,S35  0,Total,2857,2779,78
2011,S35  1,S35  1,Total,3295,3216,79
2011,S35  2,S35  2,Total,2572,2518,54
2011,S35  3,S35  3,Total,1427,1391,36
2011,S35  4,S35  4,Total,2855,2747,108
2011,S35  7,S35  7,Total,1299,1241,58
2011,S35  8,S35  8,Total,2018,1972,46
2011,S35  9,S35  9,Total,1984,1924,60
2011,S36  1,S36  1,Total,3183,3080,103
2011,S36  2,S36  2,Total,2735,2657,78
2011,S36  3,S36  3,Total,168,158,10
2011,S36  4,S36  4,Total,331,313,18
2011,S36  6,S36  6,Total,2970,2879,91
2011,S36  7,S36  7,Total,771,727,44
2011,S36  8,S36  8,Total,754,730,24
2011,S36  9,S36  9,Total,1361,1296,65
2011,S4   7,S4   7,Total,2650,2560,90
2011,S4   8,S4   8,Total,2636,2451,185
2011,S40  1,S40  1,Total,2087,1975,112
2011,S40  2,S40  2,Total,5418,5171,247
2011,S40  3,S40  3,Total,4262,4132,130
2011,S40  4,S40  4,Total,5420,5248,172
2011,S41  0,S41  0,Total,5856,5676,180
2011,S41  7,S41  7,Total,3060,2926,134
2011,S41  8,S41  8,Total,5403,5226,177
2011,S41  9,S41  9,Total,2799,2657,142
2011,S42  5,S42  5,Total,5567,5374,193
2011,S42  6,S42  6,Total,5076,4954,122
2011,S42  7,S42  7,Total,2146,2095,51
2011,S43  1,S43  1,Total,4070,3921,149
2011,S43  2,S43  2,Total,3339,3221,118
2011,S43  3,S43  3,Total,5927,5758,169
2011,S43  4,S43  4,Total,4716,4565,151
2011,S44  5,S44  5,Total,3734,3604,130
2011,S44  6,S44  6,Total,6179,5883,296
2011,S45  0,S45  0,Total,702,665,37
2011,S45  8,S45  8,Total,1748,1674,74
2011,S45  9,S45  9,Total,3866,3736,130
2011,S5   0,S5   0,Total,4832,4715,117
2011,S5   6,S5   6,Total,4807,4631,176
2011,S5   7,S5   7,Total,5686,5555,131
2011,S5   8,S5   8,Total,5807,5711,96
2011,S5   9,S5   9,Total,4144,4075,69
2011,S6   1,S6   1,Total,5136,4994,142
2011,S6   2,S6   2,Total,4029,3917,112
2011,S6   3,S6   3,Total,3568,3466,102
2011,S6   4,S6   4,Total,5897,5745,152
2011,S6   5,S6   5,Total,4881,4759,122
2011,S6   6,S6   6,Total,3392,3311,81
2011,S60  1,S60  1,Total,647,595,52
2011,S60  2,S60  2,Total,2702,2571,131
2011,S60  3,S60  3,Total,3169,3037,132
2011,S60  4,S60  4,Total,2785,2711,74
2011,S60  5,S60  5,Total,6452,6285,167
2011,S61  1,S61  1,Total,3158,2953,205
2011,S61  2,S61  2,Total,5412,5247,165
2011,S61  3,S61  3,Total,3358,3288,70
2011,S61  4,S61  4,Total,4115,3992,123
2011,S62  5,S62  5,Total,2922,2824,98
2011,S62  6,S62  6,Total,2229,2093,136
2011,S62  7,S62  7,Total,3828,3706,122
2011,S63  0,S63  0,Total,3933,3750,183
2011,S63  6,S63  6,Total,3912,3803,109
2011,S63  7,S63  7,Total,3020,2887,133
2011,S63  8,S63  8,Total,3146,2991,155
2011,S63  9,S63  9,Total,3185,2882,303
2011,S64  0,S64  0,Total,3458,3349,109
2011,S64  5,S64  5,Total,972,929,43
2011,S64  8,S64  8,Total,5819,5657,162
2011,S64  9,S64  9,Total,3551,3349,202
2011,S65  1,S65  1,Total,2467,2296,171
2011,S65  2,S65  2,Total,5577,5394,183
2011,S65  3,S65  3,Total,3786,3681,105
2011,S65  4,S65  4,Total,3435,3353,82
2011,S66  1,S66  1,Total,2452,2375,77
2011,S66  2,S66  2,Total,4195,4093,102
2011,S66  3,S66  3,Total,2624,2559,65
2011,S66  7,S66  7,Total,4538,4314,224
2011,S66  8,S66  8,Total,3907,3804,103
2011,S66  9,S66  9,Total,2294,2224,70
2011,S7   1,S7   1,Total,3872,3690,182
2011,S7   2,S7   2,Total,3159,3049,110
2011,S70  1,S70  1,Total,2964,2785,179
2011,S70  2,S70  2,Total,909,798,111
2011,S70  3,S70  3,Total,3538,3406,132
2011,S70  4,S70  4,Total,3730,3570,160
2011,S70  5,S70  5,Total,3714,3577,137
2011,S70  6,S70  6,Total,3805,3629,176
2011,S71  1,S71  1,Total,3811,3664,147
2011,S71  2,S71  2,Total,4177,4047,130
2011,S71  3,S71  3,Total,4140,4059,81
2011,S71  4,S71  4,Total,4463,4317,146
2011,S71  5,S71  5,Total,3480,3355,125
2011,S72  0,S72  0,Total,1519,1424,95
2011,S72  7,S72  7,Total,1990,1927,63
2011,S72  8,S72  8,Total,5656,5456,200
2011,S72  9,S72  9,Total,1894,1844,50
2011,S73  0,S73  0,Total,5157,4938,219
2011,S73  8,S73  8,Total,3907,3738,169
2011,S73  9,S73  9,Total,3120,2987,133
2011,S74  0,S74  0,Total,3408,3267,141
2011,S74  8,S74  8,Total,1874,1773,101
2011,S74  9,S74  9,Total,2838,2680,158
2011,S75  1,S75  1,Total,3130,3026,104
2011,S75  2,S75  2,Total,3952,3816,136
2011,S75  3,S75  3,Total,3452,3341,111
2011,S75  4,S75  4,Total,2150,2064,86
2011,S75  5,S75  5,Total,3810,3693,117
2011,S75  6,S75  6,Total,3088,2974,114
2011,S8   0,S8   0,Total,4959,4753,206
2011,S8   7,S8   7,Total,5989,5774,215
2011,S8   8,S8   8,Total,6171,6000,171
2011,S8   9,S8   9,Total,4476,4352,124
2011,S80  1,S80  1,Total,2754,2628,126
2011,S80  2,S80  2,Total,4221,4053,168
2011,S80  3,S80  3,Total,2075,2043,32
2011,S80  4,S80  4,Total,4646,4371,275
2011,S81  0,S81  0,Total,5044,4980,64
2011,S81  7,S81  7,Total,4136,4100,36
2011,S81  8,S81  8,Total,3260,3191,69
2011,S81  9,S81  9,Total,3458,3423,35
2011,S9   1,S9   1,Total,4873,4710,163
2011,S9   3,S9   3,Total,1075,1006,69
2011,S9   4,S9   4,Total,3434,3333,101
2011,S9   5,S9   5,Total,1702,1669,33
2011,SE1  0,SE1  0,Total,1984,1903,81
2011,SE1  1,SE1  1,Total,1924,1880,44
2011,SE1  2,SE1  2,Total,4474,3995,479
2011,SE1  3,SE1  3,Total,4402,4130,272
2011,SE1  4,SE1  4,Total,4488,4345,143
2011,SE1  5,SE1  5,Total,4733,4675,58
2011,SE1  6,SE1  6,Total,2944,2795,149
2011,SE1  7,SE1  7,Total,3124,2790,334
2011,SE1  8,SE1  8,Total,2043,1917,126
2011,SE1  9,SE1  9,Total,1481,1337,144
2011,SE10 0,SE10 0,Total,3619,3472,147
2011,SE10 8,SE10 8,Total,3695,3525,170
2011,SE10 9,SE10 9,Total,3931,3822,109
2011,SE11 4,SE11 4,Total,4074,3882,192
2011,SE11 5,SE11 5,Total,3431,3297,134
2011,SE11 6,SE11 6,Total,2717,2628,89
2011,SE12 0,SE12 0,Total,3718,3644,74
2011,SE12 8,SE12 8,Total,3685,3579,106
2011,SE12 9,SE12 9,Total,4317,4222,95
2011,SE13 5,SE13 5,Total,5884,5734,150
2011,SE13 6,SE13 6,Total,5374,5259,115
2011,SE13 7,SE13 7,Total,7701,7492,209
2011,SE14 5,SE14 5,Total,6548,6368,180
2011,SE14 6,SE14 6,Total,3657,3573,84
2011,SE15 1,SE15 1,Total,2773,2750,23
2011,SE15 2,SE15 2,Total,5259,5192,67
2011,SE15 3,SE15 3,Total,5961,5879,82
2011,SE15 4,SE15 4,Total,3669,3553,116
2011,SE15 5,SE15 5,Total,3748,3687,61
2011,SE15 6,SE15 6,Total,4673,4615,58
2011,SE16 2,SE16 2,Total,4199,4116,83
2011,SE16 3,SE16 3,Total,4625,4478,147
2011,SE16 4,SE16 4,Total,3313,3190,123
2011,SE16 5,SE16 5,Total,3003,2888,115
2011,SE16 6,SE16 6,Total,2190,2129,61
2011,SE16 7,SE16 7,Total,3293,3121,172
2011,SE17 1,SE17 1,Total,3354,3306,48
2011,SE17 2,SE17 2,Total,5408,5321,87
2011,SE17 3,SE17 3,Total,5325,5173,152
2011,SE18 1,SE18 1,Total,5032,4904,128
2011,SE18 2,SE18 2,Total,4099,3972,127
2011,SE18 3,SE18 3,Total,4715,4573,142
2011,SE18 4,SE18 4,Total,3077,2914,163
2011,SE18 5,SE18 5,Total,4246,4152,94
2011,SE18 6,SE18 6,Total,4597,4380,217
2011,SE18 7,SE18 7,Total,5032,4920,112
2011,SE19 1,SE19 1,Total,4101,4000,101
2011,SE19 2,SE19 2,Total,4005,3905,100
2011,SE19 3,SE19 3,Total,4935,4822,113
2011,SE2  0,SE2  0,Total,4875,4781,94
2011,SE2  9,SE2  9,Total,5719,5480,239
2011,SE20 7,SE20 7,Total,5423,5142,281
2011,SE20 8,SE20 8,Total,5460,5307,153
2011,SE21 7,SE21 7,Total,1391,1348,43
2011,SE21 8,SE21 8,Total,4785,4679,106
2011,SE22 0,SE22 0,Total,4437,4349,88
2011,SE22 8,SE22 8,Total,4583,4410,173
2011,SE22 9,SE22 9,Total,4065,3924,141
2011,SE23 1,SE23 1,Total,3852,3755,97
2011,SE23 2,SE23 2,Total,5718,5593,125
2011,SE23 3,SE23 3,Total,5305,5187,118
2011,SE24 0,SE24 0,Total,4082,3982,100
2011,SE24 9,SE24 9,Total,3966,3878,88
2011,SE25 4,SE25 4,Total,5465,5320,145
2011,SE25 5,SE25 5,Total,4316,4168,148
2011,SE25 6,SE25 6,Total,5730,5524,206
2011,SE26 4,SE26 4,Total,4476,4368,108
2011,SE26 5,SE26 5,Total,3506,3411,95
2011,SE26 6,SE26 6,Total,4848,4735,113
2011,SE27 0,SE27 0,Total,5249,5089,160
2011,SE27 9,SE27 9,Total,4112,3974,138
2011,SE28 0,SE28 0,Total,3999,3937,62
2011,SE28 8,SE28 8,Total,6788,6598,190
2011,SE3  0,SE3  0,Total,2896,2801,95
2011,SE3  7,SE3  7,Total,4287,4060,227
2011,SE3  8,SE3  8,Total,3989,3898,91
2011,SE3  9,SE3  9,Total,3406,3310,96
2011,SE4  1,SE4  1,Total,7406,7265,141
2011,SE4  2,SE4  2,Total,4771,4679,92
2011,SE5  0,SE5  0,Total,3928,3798,130
2011,SE5  7,SE5  7,Total,4272,4230,42
2011,SE5  8,SE5  8,Total,6087,5961,126
2011,SE5  9,SE5  9,Total,4933,4795,138
2011,SE6  1,SE6  1,Total,6512,6406,106
2011,SE6  2,SE6  2,Total,5376,5270,106
2011,SE6  3,SE6  3,Total,4670,4619,51
2011,SE6  4,SE6  4,Total,5075,4987,88
2011,SE7  7,SE7  7,Total,4763,4659,104
2011,SE7  8,SE7  8,Total,3726,3647,79
2011,SE8  3,SE8  3,Total,4389,4278,111
2011,SE8  4,SE8  4,Total,3460,3400,60
2011,SE8  5,SE8  5,Total,4191,4087,104
2011,SE9  1,SE9  1,Total,4842,4742,100
2011,SE9  2,SE9  2,Total,3941,3841,100
2011,SE9  3,SE9  3,Total,5137,5070,67
2011,SE9  4,SE9  4,Total,5392,5161,231
2011,SE9  5,SE9  5,Total,3191,3105,86
2011,SE9  6,SE9  6,Total,3444,3404,40
2011,SG1  1,SG1  1,Total,3243,3141,102
2011,SG1  2,SG1  2,Total,3329,3260,69
2011,SG1  3,SG1  3,Total,3651,3559,92
2011,SG1  4,SG1  4,Total,4147,4058,89
2011,SG1  5,SG1  5,Total,4924,4838,86
2011,SG1  6,SG1  6,Total,2580,2541,39
2011,SG10 6,SG10 6,Total,815,777,38
2011,SG11 1,SG11 1,Total,2021,1977,44
2011,SG11 2,SG11 2,Total,1214,1164,50
2011,SG12 0,SG12 0,Total,4039,3972,67
2011,SG12 7,SG12 7,Total,3566,3514,52
2011,SG12 8,SG12 8,Total,2802,2727,75
2011,SG12 9,SG12 9,Total,2524,2433,91
2011,SG13 7,SG13 7,Total,4329,4219,110
2011,SG13 8,SG13 8,Total,2549,2439,110
2011,SG14 1,SG14 1,Total,1482,1376,106
2011,SG14 2,SG14 2,Total,3264,3176,88
2011,SG14 3,SG14 3,Total,3862,3798,64
2011,SG15 6,SG15 6,Total,2422,2344,78
2011,SG16 6,SG16 6,Total,2669,2446,223
2011,SG17 5,SG17 5,Total,5046,4816,230
2011,SG18 0,SG18 0,Total,3340,3164,176
2011,SG18 8,SG18 8,Total,4170,4023,147
2011,SG18 9,SG18 9,Total,2903,2818,85
2011,SG19 1,SG19 1,Total,4185,4038,147
2011,SG19 2,SG19 2,Total,4018,3878,140
2011,SG19 3,SG19 3,Total,2137,2078,59
2011,SG2  0,SG2  0,Total,3339,3296,43
2011,SG2  7,SG2  7,Total,3212,3157,55
2011,SG2  8,SG2  8,Total,5363,5268,95
2011,SG2  9,SG2  9,Total,5498,5406,92
2011,SG3  6,SG3  6,Total,3102,3002,100
2011,SG4  0,SG4  0,Total,3858,3779,79
2011,SG4  7,SG4  7,Total,2061,2004,57
2011,SG4  8,SG4  8,Total,2871,2792,79
2011,SG4  9,SG4  9,Total,3855,3774,81
2011,SG5  1,SG5  1,Total,3382,3206,176
2011,SG5  2,SG5  2,Total,3715,3571,144
2011,SG5  3,SG5  3,Total,2819,2702,117
2011,SG5  4,SG5  4,Total,4156,3978,178
2011,SG6  1,SG6  1,Total,3091,3028,63
2011,SG6  2,SG6  2,Total,3194,3144,50
2011,SG6  3,SG6  3,Total,2551,2461,90
2011,SG6  4,SG6  4,Total,5435,5357,78
2011,SG7  5,SG7  5,Total,1934,1849,85
2011,SG7  6,SG7  6,Total,3863,3755,108
2011,SG8  0,SG8  0,Total,1677,1643,34
2011,SG8  5,SG8  5,Total,4267,4139,128
2011,SG8  6,SG8  6,Total,3059,2989,70
2011,SG8  7,SG8  7,Total,3338,3237,101
2011,SG8  8,SG8  8,Total,1391,1337,54
2011,SG8  9,SG8  9,Total,2302,2236,66
2011,SG9  0,SG9  0,Total,1320,1251,69
2011,SG9  9,SG9  9,Total,2548,2443,105
2011,SK1  2,SK1  2,Total,759,735,24
2011,SK1  3,SK1  3,Total,1595,1525,70
2011,SK1  4,SK1  4,Total,3475,3395,80
2011,SK10 1,SK10 1,Total,1652,1557,95
2011,SK10 2,SK10 2,Total,4856,4723,133
2011,SK10 3,SK10 3,Total,4480,4343,137
2011,SK10 4,SK10 4,Total,2818,2616,202
2011,SK10 5,SK10 5,Total,4263,4057,206
2011,SK11 0,SK11 0,Total,1935,1834,101
2011,SK11 6,SK11 6,Total,2113,1955,158
2011,SK11 7,SK11 7,Total,5384,5157,227
2011,SK11 8,SK11 8,Total,5858,5677,181
2011,SK11 9,SK11 9,Total,1919,1847,72
2011,SK12 1,SK12 1,Total,6194,6024,170
2011,SK12 2,SK12 2,Total,2170,2083,87
2011,SK13 0,SK13 0,Total,788,780,8
2011,SK13 1,SK13 1,Total,3056,2933,123
2011,SK13 2,SK13 2,Total,1571,1524,47
2011,SK13 5,SK13 5,Total,657,621,36
2011,SK13 6,SK13 6,Total,2421,2363,58
2011,SK13 7,SK13 7,Total,1822,1740,82
2011,SK13 8,SK13 8,Total,4254,4042,212
2011,SK14 1,SK14 1,Total,2322,2167,155
2011,SK14 2,SK14 2,Total,2031,1958,73
2011,SK14 3,SK14 3,Total,2850,2750,100
2011,SK14 4,SK14 4,Total,5563,5402,161
2011,SK14 5,SK14 5,Total,4393,4249,144
2011,SK14 6,SK14 6,Total,2100,1999,101
2011,SK14 8,SK14 8,Total,1390,1286,104
2011,SK15 1,SK15 1,Total,4132,3963,169
2011,SK15 2,SK15 2,Total,4171,3999,172
2011,SK15 3,SK15 3,Total,3869,3747,122
2011,SK16 4,SK16 4,Total,4028,3829,199
2011,SK16 5,SK16 5,Total,4881,4737,144
2011,SK17 0,SK17 0,Total,1415,1242,173
2011,SK17 6,SK17 6,Total,4031,3739,292
2011,SK17 7,SK17 7,Total,3222,3111,111
2011,SK17 8,SK17 8,Total,2642,2368,274
2011,SK17 9,SK17 9,Total,3530,3353,177
2011,SK2  5,SK2  5,Total,6055,5906,149
2011,SK2  6,SK2  6,Total,3569,3423,146
2011,SK2  7,SK2  7,Total,3105,3004,101
2011,SK22 1,SK22 1,Total,523,501,22
2011,SK22 2,SK22 2,Total,1124,1054,70
2011,SK22 3,SK22 3,Total,1404,1348,56
2011,SK22 4,SK22 4,Total,2533,2445,88
2011,SK23 0,SK23 0,Total,2075,1981,94
2011,SK23 6,SK23 6,Total,966,910,56
2011,SK23 7,SK23 7,Total,3583,3411,172
2011,SK23 9,SK23 9,Total,1077,1033,44
2011,SK3  0,SK3  0,Total,3123,3048,75
2011,SK3  8,SK3  8,Total,5380,5202,178
2011,SK3  9,SK3  9,Total,4348,4172,176
2011,SK4  1,SK4  1,Total,1937,1864,73
2011,SK4  2,SK4  2,Total,3416,3310,106
2011,SK4  3,SK4  3,Total,3799,3655,144
2011,SK4  4,SK4  4,Total,3480,3329,151
2011,SK4  5,SK4  5,Total,3145,3048,97
2011,SK5  6,SK5  6,Total,6336,6140,196
2011,SK5  7,SK5  7,Total,3921,3838,83
2011,SK5  8,SK5  8,Total,3230,3166,64
2011,SK6  1,SK6  1,Total,4221,4133,88
2011,SK6  2,SK6  2,Total,3148,3049,99
2011,SK6  3,SK6  3,Total,2198,2117,81
2011,SK6  4,SK6  4,Total,2999,2892,107
2011,SK6  5,SK6  5,Total,2525,2431,94
2011,SK6  6,SK6  6,Total,2835,2732,103
2011,SK6  7,SK6  7,Total,3085,2981,104
2011,SK6  8,SK6  8,Total,1830,1777,53
2011,SK7  1,SK7  1,Total,2722,2651,71
2011,SK7  2,SK7  2,Total,3029,2936,93
2011,SK7  3,SK7  3,Total,2838,2759,79
2011,SK7  4,SK7  4,Total,3556,3352,204
2011,SK7  5,SK7  5,Total,2568,2498,70
2011,SK7  6,SK7  6,Total,2666,2613,53
2011,SK8  1,SK8  1,Total,2420,2293,127
2011,SK8  2,SK8  2,Total,3255,3155,100
2011,SK8  3,SK8  3,Total,5054,4893,161
2011,SK8  4,SK8  4,Total,3530,3403,127
2011,SK8  5,SK8  5,Total,3533,3440,93
2011,SK8  6,SK8  6,Total,3296,3210,86
2011,SK8  7,SK8  7,Total,3649,3573,76
2011,SK9  1,SK9  1,Total,1195,1123,72
2011,SK9  2,SK9  2,Total,3999,3840,159
2011,SK9  3,SK9  3,Total,3098,2936,162
2011,SK9  4,SK9  4,Total,1691,1613,78
2011,SK9  5,SK9  5,Total,2410,2262,148
2011,SK9  6,SK9  6,Total,2197,2130,67
2011,SK9  7,SK9  7,Total,2834,2650,184
2011,SL0  0,SL0  0,Total,2259,2187,72
2011,SL0  9,SL0  9,Total,2212,2112,100
2011,SL1  1,SL1  1,Total,2367,2242,125
2011,SL1  2,SL1  2,Total,6132,5927,205
2011,SL1  3,SL1  3,Total,5022,4832,190
2011,SL1  4,SL1  4,Total,162,155,7
2011,SL1  5,SL1  5,Total,5300,5177,123
2011,SL1  6,SL1  6,Total,3063,3027,36
2011,SL1  7,SL1  7,Total,2262,2180,82
2011,SL1  8,SL1  8,Total,1440,1395,45
2011,SL1  9,SL1  9,Total,1168,1145,23
2011,SL2  1,SL2  1,Total,5374,5301,73
2011,SL2  2,SL2  2,Total,3174,3149,25
2011,SL2  3,SL2  3,Total,2926,2798,128
2011,SL2  4,SL2  4,Total,2355,2222,133
2011,SL2  5,SL2  5,Total,5706,5619,87
2011,SL3  0,SL3  0,Total,1747,1703,44
2011,SL3  6,SL3  6,Total,1288,1226,62
2011,SL3  7,SL3  7,Total,5191,5103,88
2011,SL3  8,SL3  8,Total,6898,6770,128
2011,SL3  9,SL3  9,Total,2662,2504,158
2011,SL4  1,SL4  1,Total,1695,1543,152
2011,SL4  2,SL4  2,Total,2901,2764,137
2011,SL4  3,SL4  3,Total,3930,3734,196
2011,SL4  4,SL4  4,Total,4493,4326,167
2011,SL4  5,SL4  5,Total,4079,3980,99
2011,SL4  6,SL4  6,Total,1866,1792,74
2011,SL5  0,SL5  0,Total,1702,1534,168
2011,SL5  7,SL5  7,Total,2259,2122,137
2011,SL5  8,SL5  8,Total,2868,2756,112
2011,SL5  9,SL5  9,Total,3080,2835,245
2011,SL6  0,SL6  0,Total,2118,2030,88
2011,SL6  1,SL6  1,Total,2386,2206,180
2011,SL6  2,SL6  2,Total,4495,4347,148
2011,SL6  3,SL6  3,Total,4483,4390,93
2011,SL6  4,SL6  4,Total,2930,2860,70
2011,SL6  5,SL6  5,Total,2693,2617,76
2011,SL6  6,SL6  6,Total,3834,3748,86
2011,SL6  7,SL6  7,Total,3737,3641,96
2011,SL6  8,SL6  8,Total,3029,2906,123
2011,SL6  9,SL6  9,Total,2639,2530,109
2011,SL7  1,SL7  1,Total,3239,3116,123
2011,SL7  2,SL7  2,Total,2353,2222,131
2011,SL7  3,SL7  3,Total,3367,3319,48
2011,SL8  5,SL8  5,Total,2906,2825,81
2011,SL9  0,SL9  0,Total,1970,1906,64
2011,SL9  7,SL9  7,Total,2013,1901,112
2011,SL9  8,SL9  8,Total,1759,1659,100
2011,SL9  9,SL9  9,Total,2388,2318,70
2011,SM1  1,SM1  1,Total,1212,1173,39
2011,SM1  2,SM1  2,Total,5997,5858,139
2011,SM1  3,SM1  3,Total,4716,4664,52
2011,SM1  4,SM1  4,Total,4683,4580,103
2011,SM2  5,SM2  5,Total,5557,5325,232
2011,SM2  6,SM2  6,Total,4828,4674,154
2011,SM2  7,SM2  7,Total,2088,2044,44
2011,SM3  8,SM3  8,Total,3031,2976,55
2011,SM3  9,SM3  9,Total,5043,4967,76
2011,SM4  4,SM4  4,Total,5548,5427,121
2011,SM4  5,SM4  5,Total,3572,3493,79
2011,SM4  6,SM4  6,Total,5171,5104,67
2011,SM5  1,SM5  1,Total,5214,5168,46
2011,SM5  2,SM5  2,Total,4825,4775,50
2011,SM5  3,SM5  3,Total,3059,3001,58
2011,SM5  4,SM5  4,Total,2358,2333,25
2011,SM6  0,SM6  0,Total,3094,2849,245
2011,SM6  7,SM6  7,Total,2731,2700,31
2011,SM6  8,SM6  8,Total,4793,4705,88
2011,SM6  9,SM6  9,Total,5062,4915,147
2011,SM7  1,SM7  1,Total,2639,2583,56
2011,SM7  2,SM7  2,Total,2873,2813,60
2011,SM7  3,SM7  3,Total,1752,1717,35
2011,SN1  1,SN1  1,Total,431,409,22
2011,SN1  2,SN1  2,Total,3595,3375,220
2011,SN1  3,SN1  3,Total,3224,3002,222
2011,SN1  4,SN1  4,Total,3344,3211,133
2011,SN1  5,SN1  5,Total,2834,2624,210
2011,SN1  7,SN1  7,Total,440,354,86
2011,SN10 1,SN10 1,Total,2168,2062,106
2011,SN10 2,SN10 2,Total,2856,2784,72
2011,SN10 3,SN10 3,Total,3198,3100,98
2011,SN10 4,SN10 4,Total,2152,2046,106
2011,SN10 5,SN10 5,Total,3411,3305,106
2011,SN11 0,SN11 0,Total,2609,2523,86
2011,SN11 8,SN11 8,Total,3241,3149,92
2011,SN11 9,SN11 9,Total,3532,3423,109
2011,SN12 6,SN12 6,Total,4096,3994,102
2011,SN12 7,SN12 7,Total,4280,4168,112
2011,SN12 8,SN12 8,Total,2389,2332,57
2011,SN13 0,SN13 0,Total,2191,2115,76
2011,SN13 8,SN13 8,Total,1119,1069,50
2011,SN13 9,SN13 9,Total,3972,3818,154
2011,SN14 0,SN14 0,Total,5309,5225,84
2011,SN14 6,SN14 6,Total,2875,2764,111
2011,SN14 7,SN14 7,Total,1193,1121,72
2011,SN14 8,SN14 8,Total,2067,1969,98
2011,SN15 1,SN15 1,Total,2857,2704,153
2011,SN15 2,SN15 2,Total,2251,2156,95
2011,SN15 3,SN15 3,Total,5130,4989,141
2011,SN15 4,SN15 4,Total,3149,2952,197
2011,SN15 5,SN15 5,Total,1445,1383,62
2011,SN16 0,SN16 0,Total,2669,2509,160
2011,SN16 9,SN16 9,Total,3364,3213,151
2011,SN2  1,SN2  1,Total,5822,5657,165
2011,SN2  2,SN2  2,Total,4860,4652,208
2011,SN2  5,SN2  5,Total,2553,2516,37
2011,SN2  7,SN2  7,Total,3848,3770,78
2011,SN2  8,SN2  8,Total,1087,1059,28
2011,SN25 1,SN25 1,Total,4169,4082,87
2011,SN25 2,SN25 2,Total,4072,3955,117
2011,SN25 3,SN25 3,Total,3383,3330,53
2011,SN25 4,SN25 4,Total,3034,2991,43
2011,SN26 7,SN26 7,Total,603,594,9
2011,SN26 8,SN26 8,Total,116,112,4
2011,SN3  1,SN3  1,Total,3644,3388,256
2011,SN3  2,SN3  2,Total,4647,4562,85
2011,SN3  3,SN3  3,Total,3873,3803,70
2011,SN3  4,SN3  4,Total,5363,5248,115
2011,SN3  5,SN3  5,Total,2011,1981,30
2011,SN3  6,SN3  6,Total,2766,2724,42
2011,SN4  0,SN4  0,Total,3125,3037,88
2011,SN4  7,SN4  7,Total,3083,2977,106
2011,SN4  8,SN4  8,Total,2731,2673,58
2011,SN4  9,SN4  9,Total,2875,2811,64
2011,SN5  0,SN5  0,Total,128,121,7
2011,SN5  3,SN5  3,Total,456,446,10
2011,SN5  4,SN5  4,Total,1646,1580,66
2011,SN5  5,SN5  5,Total,3534,3477,57
2011,SN5  6,SN5  6,Total,1987,1943,44
2011,SN5  7,SN5  7,Total,1758,1696,62
2011,SN5  8,SN5  8,Total,4529,4425,104
2011,SN6  6,SN6  6,Total,2998,2879,119
2011,SN6  7,SN6  7,Total,4013,3877,136
2011,SN6  8,SN6  8,Total,2290,2087,203
2011,SN7  7,SN7  7,Total,3908,3756,152
2011,SN7  8,SN7  8,Total,1920,1824,96
2011,SN8  1,SN8  1,Total,2802,2644,158
2011,SN8  2,SN8  2,Total,2692,2547,145
2011,SN8  3,SN8  3,Total,3020,2868,152
2011,SN8  4,SN8  4,Total,1931,1834,97
2011,SN9  5,SN9  5,Total,2351,2251,100
2011,SN9  6,SN9  6,Total,1384,1301,83
2011,SO14 0,SO14 0,Total,2696,2567,129
2011,SO14 1,SO14 1,Total,1341,1293,48
2011,SO14 2,SO14 2,Total,795,737,58
2011,SO14 3,SO14 3,Total,2891,2660,231
2011,SO14 5,SO14 5,Total,1135,1109,26
2011,SO14 6,SO14 6,Total,2395,2303,92
2011,SO14 7,SO14 7,Total,107,100,7
2011,SO15 0,SO15 0,Total,589,584,5
2011,SO15 1,SO15 1,Total,795,769,26
2011,SO15 2,SO15 2,Total,4394,4188,206
2011,SO15 3,SO15 3,Total,3513,3359,154
2011,SO15 4,SO15 4,Total,1250,1222,28
2011,SO15 5,SO15 5,Total,5665,5455,210
2011,SO15 7,SO15 7,Total,1184,1161,23
2011,SO15 8,SO15 8,Total,1660,1626,34
2011,SO16 0,SO16 0,Total,714,613,101
2011,SO16 2,SO16 2,Total,359,352,7
2011,SO16 3,SO16 3,Total,3862,3732,130
2011,SO16 4,SO16 4,Total,3029,2970,59
2011,SO16 5,SO16 5,Total,3114,3068,46
2011,SO16 6,SO16 6,Total,3184,3086,98
2011,SO16 7,SO16 7,Total,2690,2577,113
2011,SO16 8,SO16 8,Total,5241,5143,98
2011,SO16 9,SO16 9,Total,5111,5045,66
2011,SO17 1,SO17 1,Total,2972,2865,107
2011,SO17 2,SO17 2,Total,3167,3051,116
2011,SO17 3,SO17 3,Total,1667,1609,58
2011,SO18 1,SO18 1,Total,3756,3614,142
2011,SO18 2,SO18 2,Total,4023,3939,84
2011,SO18 3,SO18 3,Total,1950,1910,40
2011,SO18 4,SO18 4,Total,1793,1740,53
2011,SO18 5,SO18 5,Total,3323,3269,54
2011,SO18 6,SO18 6,Total,1110,1081,29
2011,SO19 0,SO19 0,Total,1591,1569,22
2011,SO19 1,SO19 1,Total,1318,1302,16
2011,SO19 2,SO19 2,Total,2709,2645,64
2011,SO19 4,SO19 4,Total,853,796,57
2011,SO19 5,SO19 5,Total,698,688,10
2011,SO19 6,SO19 6,Total,4159,4083,76
2011,SO19 7,SO19 7,Total,3163,3079,84
2011,SO19 8,SO19 8,Total,3602,3531,71
2011,SO19 9,SO19 9,Total,6591,6457,134
2011,SO20 6,SO20 6,Total,2010,1897,113
2011,SO20 8,SO20 8,Total,1473,1398,75
2011,SO21 1,SO21 1,Total,3192,3052,140
2011,SO21 2,SO21 2,Total,2400,2227,173
2011,SO21 3,SO21 3,Total,2545,2434,111
2011,SO22 4,SO22 4,Total,4511,4396,115
2011,SO22 5,SO22 5,Total,2747,2639,108
2011,SO22 6,SO22 6,Total,3793,3616,177
2011,SO23 0,SO23 0,Total,2361,2303,58
2011,SO23 7,SO23 7,Total,4050,3880,170
2011,SO23 8,SO23 8,Total,1575,1418,157
2011,SO23 9,SO23 9,Total,2199,2043,156
2011,SO24 0,SO24 0,Total,1710,1619,91
2011,SO24 9,SO24 9,Total,3181,3036,145
2011,SO30 0,SO30 0,Total,2800,2751,49
2011,SO30 2,SO30 2,Total,5575,5467,108
2011,SO30 3,SO30 3,Total,2764,2674,90
2011,SO30 4,SO30 4,Total,2407,2356,51
2011,SO31 1,SO31 1,Total,734,704,30
2011,SO31 4,SO31 4,Total,2207,2086,121
2011,SO31 5,SO31 5,Total,2923,2829,94
2011,SO31 6,SO31 6,Total,4713,4594,119
2011,SO31 7,SO31 7,Total,2812,2730,82
2011,SO31 8,SO31 8,Total,2985,2918,67
2011,SO31 9,SO31 9,Total,2790,2726,64
2011,SO32 1,SO32 1,Total,3291,3143,148
2011,SO32 2,SO32 2,Total,3824,3708,116
2011,SO32 3,SO32 3,Total,1269,1170,99
2011,SO40 2,SO40 2,Total,3748,3696,52
2011,SO40 3,SO40 3,Total,3169,3105,64
2011,SO40 4,SO40 4,Total,2497,2446,51
2011,SO40 7,SO40 7,Total,2211,2176,35
2011,SO40 8,SO40 8,Total,3514,3467,47
2011,SO40 9,SO40 9,Total,2433,2373,60
2011,SO41 0,SO41 0,Total,5154,4692,462
2011,SO41 3,SO41 3,Total,1538,1394,144
2011,SO41 5,SO41 5,Total,655,594,61
2011,SO41 6,SO41 6,Total,1599,1507,92
2011,SO41 8,SO41 8,Total,3241,3096,145
2011,SO41 9,SO41 9,Total,3539,3248,291
2011,SO42 7,SO42 7,Total,2447,2205,242
2011,SO43 7,SO43 7,Total,2117,1938,179
2011,SO45 1,SO45 1,Total,3393,3286,107
2011,SO45 2,SO45 2,Total,2756,2720,36
2011,SO45 3,SO45 3,Total,1907,1878,29
2011,SO45 4,SO45 4,Total,2256,2233,23
2011,SO45 5,SO45 5,Total,3212,3151,61
2011,SO45 6,SO45 6,Total,1915,1786,129
2011,SO50 4,SO50 4,Total,3927,3830,97
2011,SO50 5,SO50 5,Total,4330,4209,121
2011,SO50 6,SO50 6,Total,2651,2610,41
2011,SO50 7,SO50 7,Total,3194,3141,53
2011,SO50 8,SO50 8,Total,2771,2730,41
2011,SO50 9,SO50 9,Total,2500,2449,51
2011,SO51 0,SO51 0,Total,1678,1574,104
2011,SO51 5,SO51 5,Total,1737,1704,33
2011,SO51 6,SO51 6,Total,1868,1791,77
2011,SO51 7,SO51 7,Total,3572,3514,58
2011,SO51 8,SO51 8,Total,2450,2350,100
2011,SO51 9,SO51 9,Total,359,340,19
2011,SO52 9,SO52 9,Total,3091,3022,69
2011,SO53 1,SO53 1,Total,2098,2054,44
2011,SO53 2,SO53 2,Total,3733,3662,71
2011,SO53 3,SO53 3,Total,2838,2769,69
2011,SO53 4,SO53 4,Total,2767,2730,37
2011,SO53 5,SO53 5,Total,2011,1972,39
2011,SP1  1,SP1  1,Total,2233,2156,77
2011,SP1  2,SP1  2,Total,1931,1812,119
2011,SP1  3,SP1  3,Total,5463,5325,138
2011,SP10 1,SP10 1,Total,1813,1781,32
2011,SP10 2,SP10 2,Total,4345,4253,92
2011,SP10 3,SP10 3,Total,5865,5749,116
2011,SP10 4,SP10 4,Total,2675,2635,40
2011,SP10 5,SP10 5,Total,2331,2300,31
2011,SP11 0,SP11 0,Total,1465,1383,82
2011,SP11 6,SP11 6,Total,1836,1746,90
2011,SP11 7,SP11 7,Total,1896,1834,62
2011,SP11 8,SP11 8,Total,1730,1661,69
2011,SP11 9,SP11 9,Total,2759,2672,87
2011,SP2  0,SP2  0,Total,2261,2183,78
2011,SP2  7,SP2  7,Total,3656,3478,178
2011,SP2  8,SP2  8,Total,3609,3503,106
2011,SP2  9,SP2  9,Total,3643,3552,91
2011,SP3  4,SP3  4,Total,1909,1809,100
2011,SP3  5,SP3  5,Total,1398,1286,112
2011,SP3  6,SP3  6,Total,2050,1898,152
2011,SP4  0,SP4  0,Total,1138,1096,42
2011,SP4  6,SP4  6,Total,1714,1636,78
2011,SP4  7,SP4  7,Total,4488,4310,178
2011,SP4  8,SP4  8,Total,2868,2768,100
2011,SP4  9,SP4  9,Total,2069,1852,217
2011,SP5  1,SP5  1,Total,1952,1866,86
2011,SP5  2,SP5  2,Total,2529,2453,76
2011,SP5  3,SP5  3,Total,2575,2488,87
2011,SP5  4,SP5  4,Total,987,951,36
2011,SP5  5,SP5  5,Total,1533,1434,99
2011,SP6  1,SP6  1,Total,2900,2779,121
2011,SP6  2,SP6  2,Total,1266,1181,85
2011,SP6  3,SP6  3,Total,2088,1994,94
2011,SP7  0,SP7  0,Total,1064,973,91
2011,SP7  8,SP7  8,Total,3395,3139,256
2011,SP7  9,SP7  9,Total,1688,1540,148
2011,SP8  4,SP8  4,Total,5127,4901,226
2011,SP8  5,SP8  5,Total,1556,1430,126
2011,SP9  7,SP9  7,Total,3101,2955,146
2011,SR1  1,SR1  1,Total,444,369,75
2011,SR1  2,SR1  2,Total,1764,1709,55
2011,SR1  3,SR1  3,Total,549,528,21
2011,SR2  0,SR2  0,Total,4103,4050,53
2011,SR2  7,SR2  7,Total,4386,4069,317
2011,SR2  8,SR2  8,Total,3407,3163,244
2011,SR2  9,SR2  9,Total,3334,3293,41
2011,SR3  1,SR3  1,Total,5466,5353,113
2011,SR3  2,SR3  2,Total,4539,4420,119
2011,SR3  3,SR3  3,Total,4548,4441,107
2011,SR3  4,SR3  4,Total,3094,3049,45
2011,SR4  0,SR4  0,Total,3018,2966,52
2011,SR4  6,SR4  6,Total,3673,3496,177
2011,SR4  7,SR4  7,Total,4307,4121,186
2011,SR4  8,SR4  8,Total,4068,3972,96
2011,SR4  9,SR4  9,Total,2907,2862,45
2011,SR5  1,SR5  1,Total,2821,2718,103
2011,SR5  2,SR5  2,Total,2524,2429,95
2011,SR5  3,SR5  3,Total,3655,3564,91
2011,SR5  4,SR5  4,Total,2785,2738,47
2011,SR5  5,SR5  5,Total,3998,3923,75
2011,SR6  0,SR6  0,Total,2872,2724,148
2011,SR6  7,SR6  7,Total,4469,4327,142
2011,SR6  8,SR6  8,Total,2677,2601,76
2011,SR6  9,SR6  9,Total,3887,3780,107
2011,SR7  0,SR7  0,Total,2567,2528,39
2011,SR7  7,SR7  7,Total,4496,4332,164
2011,SR7  8,SR7  8,Total,3390,3321,69
2011,SR7  9,SR7  9,Total,3466,3381,85
2011,SR8  1,SR8  1,Total,2000,1971,29
2011,SR8  2,SR8  2,Total,3515,3462,53
2011,SR8  3,SR8  3,Total,3644,3416,228
2011,SR8  4,SR8  4,Total,3667,3537,130
2011,SR8  5,SR8  5,Total,3029,2988,41
2011,SS0  0,SS0  0,Total,4256,4106,150
2011,SS0  7,SS0  7,Total,5316,4709,607
2011,SS0  8,SS0  8,Total,3636,3404,232
2011,SS0  9,SS0  9,Total,5974,5554,420
2011,SS1  1,SS1  1,Total,1584,1390,194
2011,SS1  2,SS1  2,Total,7071,6263,808
2011,SS1  3,SS1  3,Total,3945,3790,155
2011,SS11 7,SS11 7,Total,2964,2873,91
2011,SS11 8,SS11 8,Total,4172,4074,98
2011,SS12 0,SS12 0,Total,3022,2963,59
2011,SS12 9,SS12 9,Total,4582,4514,68
2011,SS13 1,SS13 1,Total,3940,3878,62
2011,SS13 2,SS13 2,Total,2245,2204,41
2011,SS13 3,SS13 3,Total,3278,3234,44
2011,SS14 1,SS14 1,Total,4088,4013,75
2011,SS14 2,SS14 2,Total,4755,4691,64
2011,SS14 3,SS14 3,Total,1782,1718,64
2011,SS15 4,SS15 4,Total,2375,2352,23
2011,SS15 5,SS15 5,Total,6683,6609,74
2011,SS15 6,SS15 6,Total,3885,3839,46
2011,SS16 4,SS16 4,Total,5068,5005,63
2011,SS16 5,SS16 5,Total,4207,4079,128
2011,SS16 6,SS16 6,Total,3112,3079,33
2011,SS17 0,SS17 0,Total,3410,3309,101
2011,SS17 7,SS17 7,Total,4731,4653,78
2011,SS17 8,SS17 8,Total,3506,3447,59
2011,SS17 9,SS17 9,Total,1761,1722,39
2011,SS2  4,SS2  4,Total,7211,6923,288
2011,SS2  5,SS2  5,Total,3945,3753,192
2011,SS2  6,SS2  6,Total,5348,5082,266
2011,SS3  0,SS3  0,Total,2949,2857,92
2011,SS3  8,SS3  8,Total,2401,2332,69
2011,SS3  9,SS3  9,Total,6624,6357,267
2011,SS4  1,SS4  1,Total,5190,5004,186
2011,SS4  2,SS4  2,Total,325,310,15
2011,SS4  3,SS4  3,Total,3387,3317,70
2011,SS5  4,SS5  4,Total,3773,3699,74
2011,SS5  5,SS5  5,Total,2487,2442,45
2011,SS5  6,SS5  6,Total,2698,2631,67
2011,SS6  7,SS6  7,Total,2926,2816,110
2011,SS6  8,SS6  8,Total,5137,5020,117
2011,SS6  9,SS6  9,Total,4974,4867,107
2011,SS7  1,SS7  1,Total,3659,3566,93
2011,SS7  2,SS7  2,Total,4528,4335,193
2011,SS7  3,SS7  3,Total,4683,4564,119
2011,SS7  4,SS7  4,Total,3572,3497,75
2011,SS7  5,SS7  5,Total,4468,4357,111
2011,SS8  0,SS8  0,Total,3189,2914,275
2011,SS8  7,SS8  7,Total,3587,3483,104
2011,SS8  8,SS8  8,Total,3646,3536,110
2011,SS8  9,SS8  9,Total,6103,5938,165
2011,SS9  1,SS9  1,Total,4541,4295,246
2011,SS9  2,SS9  2,Total,3801,3644,157
2011,SS9  3,SS9  3,Total,4496,4400,96
2011,SS9  4,SS9  4,Total,4493,4331,162
2011,SS9  5,SS9  5,Total,5107,4953,154
2011,ST1  2,ST1  2,Total,1866,1794,72
2011,ST1  3,ST1  3,Total,2687,2541,146
2011,ST1  4,ST1  4,Total,1693,1589,104
2011,ST1  5,ST1  5,Total,1663,1540,123
2011,ST1  6,ST1  6,Total,6164,5983,181
2011,ST10 1,ST10 1,Total,4970,4802,168
2011,ST10 2,ST10 2,Total,2338,2231,107
2011,ST10 3,ST10 3,Total,1072,989,83
2011,ST10 4,ST10 4,Total,2958,2860,98
2011,ST11 9,ST11 9,Total,4443,4306,137
2011,ST12 9,ST12 9,Total,1738,1663,75
2011,ST13 5,ST13 5,Total,3185,2990,195
2011,ST13 6,ST13 6,Total,2817,2714,103
2011,ST13 7,ST13 7,Total,2938,2799,139
2011,ST13 8,ST13 8,Total,3956,3771,185
2011,ST14 5,ST14 5,Total,1919,1852,67
2011,ST14 7,ST14 7,Total,3640,3538,102
2011,ST14 8,ST14 8,Total,2790,2683,107
2011,ST15 0,ST15 0,Total,4027,3911,116
2011,ST15 8,ST15 8,Total,5520,5298,222
2011,ST16 1,ST16 1,Total,5568,5436,132
2011,ST16 2,ST16 2,Total,970,900,70
2011,ST16 3,ST16 3,Total,7288,6971,317
2011,ST17 0,ST17 0,Total,5136,5014,122
2011,ST17 4,ST17 4,Total,5536,5343,193
2011,ST17 9,ST17 9,Total,6894,6744,150
2011,ST18 0,ST18 0,Total,4317,4162,155
2011,ST18 9,ST18 9,Total,2363,2283,80
2011,ST19 5,ST19 5,Total,3635,3535,100
2011,ST19 9,ST19 9,Total,2783,2684,99
2011,ST2  0,ST2  0,Total,4514,4453,61
2011,ST2  7,ST2  7,Total,3679,3551,128
2011,ST2  8,ST2  8,Total,3155,3117,38
2011,ST2  9,ST2  9,Total,3912,3832,80
2011,ST20 0,ST20 0,Total,2949,2853,96
2011,ST21 6,ST21 6,Total,2504,2379,125
2011,ST3  1,ST3  1,Total,2686,2629,57
2011,ST3  2,ST3  2,Total,3525,3446,79
2011,ST3  3,ST3  3,Total,3678,3562,116
2011,ST3  4,ST3  4,Total,3826,3596,230
2011,ST3  5,ST3  5,Total,5818,5702,116
2011,ST3  6,ST3  6,Total,4456,4247,209
2011,ST3  7,ST3  7,Total,5571,5410,161
2011,ST4  1,ST4  1,Total,789,735,54
2011,ST4  2,ST4  2,Total,2887,2664,223
2011,ST4  3,ST4  3,Total,3603,3356,247
2011,ST4  4,ST4  4,Total,3186,3038,148
2011,ST4  5,ST4  5,Total,3697,3558,139
2011,ST4  6,ST4  6,Total,3496,3362,134
2011,ST4  7,ST4  7,Total,3270,3098,172
2011,ST4  8,ST4  8,Total,5140,5024,116
2011,ST5  0,ST5  0,Total,4378,4225,153
2011,ST5  1,ST5  1,Total,1646,1565,81
2011,ST5  2,ST5  2,Total,4457,4293,164
2011,ST5  3,ST5  3,Total,4297,4187,110
2011,ST5  4,ST5  4,Total,2788,2735,53
2011,ST5  5,ST5  5,Total,1246,1178,68
2011,ST5  6,ST5  6,Total,3922,3835,87
2011,ST5  7,ST5  7,Total,4820,4675,145
2011,ST5  8,ST5  8,Total,5042,4900,142
2011,ST5  9,ST5  9,Total,3434,3315,119
2011,ST6  1,ST6  1,Total,3608,3439,169
2011,ST6  2,ST6  2,Total,1301,1218,83
2011,ST6  3,ST6  3,Total,1463,1362,101
2011,ST6  4,ST6  4,Total,2235,2105,130
2011,ST6  5,ST6  5,Total,4610,4326,284
2011,ST6  6,ST6  6,Total,5912,5688,224
2011,ST6  7,ST6  7,Total,4116,4033,83
2011,ST6  8,ST6  8,Total,5645,5414,231
2011,ST7  1,ST7  1,Total,4842,4736,106
2011,ST7  2,ST7  2,Total,5443,5235,208
2011,ST7  3,ST7  3,Total,3366,3259,107
2011,ST7  4,ST7  4,Total,6339,6162,177
2011,ST7  8,ST7  8,Total,3567,3448,119
2011,ST8  6,ST8  6,Total,5034,4844,190
2011,ST8  7,ST8  7,Total,4034,3909,125
2011,ST9  0,ST9  0,Total,2672,2614,58
2011,ST9  9,ST9  9,Total,2415,2312,103
2011,SW10 0,SW10 0,Total,4786,4442,344
2011,SW10 9,SW10 9,Total,5415,4918,497
2011,SW11 1,SW11 1,Total,4613,4391,222
2011,SW11 2,SW11 2,Total,6465,6288,177
2011,SW11 3,SW11 3,Total,5732,5428,304
2011,SW11 4,SW11 4,Total,4234,3937,297
2011,SW11 5,SW11 5,Total,7859,7648,211
2011,SW11 6,SW11 6,Total,4363,4228,135
2011,SW12 0,SW12 0,Total,3285,3227,58
2011,SW12 8,SW12 8,Total,5468,5267,201
2011,SW12 9,SW12 9,Total,5158,4950,208
2011,SW13 0,SW13 0,Total,3066,2969,97
2011,SW13 8,SW13 8,Total,973,874,99
2011,SW13 9,SW13 9,Total,3173,3016,157
2011,SW14 7,SW14 7,Total,3238,3138,100
2011,SW14 8,SW14 8,Total,4026,3890,136
2011,SW15 1,SW15 1,Total,4519,4349,170
2011,SW15 2,SW15 2,Total,5037,4834,203
2011,SW15 3,SW15 3,Total,5033,4872,161
2011,SW15 4,SW15 4,Total,3973,3912,61
2011,SW15 5,SW15 5,Total,4060,3835,225
2011,SW15 6,SW15 6,Total,3912,3762,150
2011,SW16 1,SW16 1,Total,4913,4709,204
2011,SW16 2,SW16 2,Total,7385,6996,389
2011,SW16 3,SW16 3,Total,3486,3373,113
2011,SW16 4,SW16 4,Total,5040,4880,160
2011,SW16 5,SW16 5,Total,6729,6471,258
2011,SW16 6,SW16 6,Total,5844,5469,375
2011,SW17 0,SW17 0,Total,6229,6034,195
2011,SW17 6,SW17 6,Total,889,869,20
2011,SW17 7,SW17 7,Total,5234,5006,228
2011,SW17 8,SW17 8,Total,8221,7866,355
2011,SW17 9,SW17 9,Total,6309,6088,221
2011,SW18 1,SW18 1,Total,5277,4979,298
2011,SW18 2,SW18 2,Total,4357,4219,138
2011,SW18 3,SW18 3,Total,5602,5436,166
2011,SW18 4,SW18 4,Total,4868,4689,179
2011,SW18 5,SW18 5,Total,5510,5341,169
2011,SW19 1,SW19 1,Total,4916,4780,136
2011,SW19 2,SW19 2,Total,5392,5278,114
2011,SW19 3,SW19 3,Total,4388,4267,121
2011,SW19 4,SW19 4,Total,3266,3066,200
2011,SW19 5,SW19 5,Total,1779,1672,107
2011,SW19 6,SW19 6,Total,5065,4911,154
2011,SW19 7,SW19 7,Total,2788,2656,132
2011,SW19 8,SW19 8,Total,6449,6265,184
2011,SW1A 1,SW1A 1,Total,224,149,75
2011,SW1E 5,SW1E 5,Total,143,107,36
2011,SW1E 6,SW1E 6,Total,264,203,61
2011,SW1H 0,SW1H 0,Total,269,219,50
2011,SW1H 9,SW1H 9,Total,295,208,87
2011,SW1P 1,SW1P 1,Total,1414,1238,176
2011,SW1P 2,SW1P 2,Total,1987,1774,213
2011,SW1P 3,SW1P 3,Total,423,334,89
2011,SW1P 4,SW1P 4,Total,3774,3367,407
2011,SW1V 1,SW1V 1,Total,1150,1044,106
2011,SW1V 2,SW1V 2,Total,3465,3168,297
2011,SW1V 3,SW1V 3,Total,4833,4370,463
2011,SW1V 4,SW1V 4,Total,3410,3220,190
2011,SW1W 0,SW1W 0,Total,394,303,91
2011,SW1W 8,SW1W 8,Total,3470,3000,470
2011,SW1W 9,SW1W 9,Total,1471,1115,356
2011,SW1X 0,SW1X 0,Total,1432,1056,376
2011,SW1X 7,SW1X 7,Total,613,467,146
2011,SW1X 8,SW1X 8,Total,1006,755,251
2011,SW1X 9,SW1X 9,Total,1335,912,423
2011,SW1Y 4,SW1Y 4,Total,236,165,71
2011,SW1Y 6,SW1Y 6,Total,215,161,54
2011,SW2  1,SW2  1,Total,3311,3244,67
2011,SW2  2,SW2  2,Total,5189,5072,117
2011,SW2  3,SW2  3,Total,5782,5654,128
2011,SW2  4,SW2  4,Total,5024,4922,102
2011,SW2  5,SW2  5,Total,4350,4271,79
2011,SW20 0,SW20 0,Total,3808,3704,104
2011,SW20 8,SW20 8,Total,4863,4679,184
2011,SW20 9,SW20 9,Total,3312,3246,66
2011,SW3  1,SW3  1,Total,936,677,259
2011,SW3  2,SW3  2,Total,2815,2294,521
2011,SW3  3,SW3  3,Total,3608,2677,931
2011,SW3  4,SW3  4,Total,2282,2021,261
2011,SW3  5,SW3  5,Total,2930,2691,239
2011,SW3  6,SW3  6,Total,1594,1395,199
2011,SW4  0,SW4  0,Total,3057,2959,98
2011,SW4  6,SW4  6,Total,4553,4473,80
2011,SW4  7,SW4  7,Total,3711,3656,55
2011,SW4  8,SW4  8,Total,3079,3031,48
2011,SW4  9,SW4  9,Total,3010,2951,59
2011,SW5  0,SW5  0,Total,3885,3583,302
2011,SW5  9,SW5  9,Total,4992,4739,253
2011,SW6  1,SW6  1,Total,3702,3480,222
2011,SW6  2,SW6  2,Total,5852,5495,357
2011,SW6  3,SW6  3,Total,4057,3830,227
2011,SW6  4,SW6  4,Total,3462,3307,155
2011,SW6  5,SW6  5,Total,3377,3213,164
2011,SW6  6,SW6  6,Total,5097,4911,186
2011,SW6  7,SW6  7,Total,4616,4349,267
2011,SW7  1,SW7  1,Total,1993,1324,669
2011,SW7  2,SW7  2,Total,1088,888,200
2011,SW7  3,SW7  3,Total,2455,2095,360
2011,SW7  4,SW7  4,Total,2748,2502,246
2011,SW7  5,SW7  5,Total,2970,2536,434
2011,SW8  1,SW8  1,Total,5054,4894,160
2011,SW8  2,SW8  2,Total,4817,4593,224
2011,SW8  3,SW8  3,Total,3021,2896,125
2011,SW8  4,SW8  4,Total,4203,3943,260
2011,SW8  5,SW8  5,Total,210,187,23
2011,SW9  0,SW9  0,Total,5036,4919,117
2011,SW9  6,SW9  6,Total,2623,2538,85
2011,SW9  7,SW9  7,Total,3744,3654,90
2011,SW9  8,SW9  8,Total,2565,2509,56
2011,SW9  9,SW9  9,Total,5166,5034,132
2011,SY1  1,SY1  1,Total,986,861,125
2011,SY1  2,SY1  2,Total,3512,3337,175
2011,SY1  3,SY1  3,Total,3469,3411,58
2011,SY1  4,SY1  4,Total,3897,3801,96
2011,SY10 0,SY10 0,Total,1132,966,166
2011,SY10 7,SY10 7,Total,1663,1565,98
2011,SY10 8,SY10 8,Total,1550,1479,71
2011,SY10 9,SY10 9,Total,2065,1980,85
2011,SY11 1,SY11 1,Total,2973,2831,142
2011,SY11 2,SY11 2,Total,4862,4687,175
2011,SY11 3,SY11 3,Total,2386,2290,96
2011,SY11 4,SY11 4,Total,1852,1792,60
2011,SY12 0,SY12 0,Total,2027,1934,93
2011,SY12 9,SY12 9,Total,1531,1469,62
2011,SY13 1,SY13 1,Total,4389,4217,172
2011,SY13 2,SY13 2,Total,1715,1642,73
2011,SY13 3,SY13 3,Total,1239,1197,42
2011,SY13 4,SY13 4,Total,1151,1102,49
2011,SY14 7,SY14 7,Total,1064,1015,49
2011,SY14 8,SY14 8,Total,1451,1388,63
2011,SY15 6,SY15 6,Total,2336,2195,141
2011,SY16 1,SY16 1,Total,2854,2776,78
2011,SY16 2,SY16 2,Total,2178,2080,98
2011,SY16 3,SY16 3,Total,1186,1108,78
2011,SY16 4,SY16 4,Total,1116,1052,64
2011,SY17 5,SY17 5,Total,1659,1540,119
2011,SY18 6,SY18 6,Total,2310,2126,184
2011,SY19 7,SY19 7,Total,581,503,78
2011,SY2  5,SY2  5,Total,5044,4930,114
2011,SY2  6,SY2  6,Total,2712,2627,85
2011,SY20 8,SY20 8,Total,2297,2067,230
2011,SY20 9,SY20 9,Total,1354,1074,280
2011,SY21 0,SY21 0,Total,1288,1156,132
2011,SY21 7,SY21 7,Total,2785,2661,124
2011,SY21 8,SY21 8,Total,2077,1960,117
2011,SY21 9,SY21 9,Total,1250,1190,60
2011,SY22 5,SY22 5,Total,965,868,97
2011,SY22 6,SY22 6,Total,3410,3146,264
2011,SY23 1,SY23 1,Total,3188,3036,152
2011,SY23 2,SY23 2,Total,1561,1456,105
2011,SY23 3,SY23 3,Total,3901,3709,192
2011,SY23 4,SY23 4,Total,2420,2225,195
2011,SY23 5,SY23 5,Total,1337,1209,128
2011,SY24 5,SY24 5,Total,2245,2025,220
2011,SY25 6,SY25 6,Total,2195,1969,226
2011,SY3  0,SY3  0,Total,2172,2125,47
2011,SY3  5,SY3  5,Total,1997,1932,65
2011,SY3  6,SY3  6,Total,1225,1204,21
2011,SY3  7,SY3  7,Total,3633,3518,115
2011,SY3  8,SY3  8,Total,4001,3861,140
2011,SY3  9,SY3  9,Total,2097,2038,59
2011,SY4  1,SY4  1,Total,1214,1168,46
2011,SY4  2,SY4  2,Total,1041,1006,35
2011,SY4  3,SY4  3,Total,1724,1662,62
2011,SY4  4,SY4  4,Total,2404,2304,100
2011,SY4  5,SY4  5,Total,3883,3708,175
2011,SY5  0,SY5  0,Total,2805,2682,123
2011,SY5  6,SY5  6,Total,1753,1679,74
2011,SY5  7,SY5  7,Total,1204,1156,48
2011,SY5  8,SY5  8,Total,1335,1303,32
2011,SY5  9,SY5  9,Total,1969,1888,81
2011,SY6  6,SY6  6,Total,2085,1913,172
2011,SY6  7,SY6  7,Total,1091,1026,65
2011,SY7  0,SY7  0,Total,1699,1545,154
2011,SY7  8,SY7  8,Total,1784,1620,164
2011,SY7  9,SY7  9,Total,2188,2050,138
2011,SY8  1,SY8  1,Total,4359,4051,308
2011,SY8  2,SY8  2,Total,1585,1502,83
2011,SY8  3,SY8  3,Total,1498,1410,88
2011,SY8  4,SY8  4,Total,1605,1494,111
2011,SY9  5,SY9  5,Total,1362,1251,111
2011,TA1  1,TA1  1,Total,3028,2789,239
2011,TA1  2,TA1  2,Total,5754,5576,178
2011,TA1  3,TA1  3,Total,3769,3528,241
2011,TA1  4,TA1  4,Total,2908,2718,190
2011,TA1  5,TA1  5,Total,2908,2810,98
2011,TA10 0,TA10 0,Total,1753,1659,94
2011,TA10 9,TA10 9,Total,2436,2280,156
2011,TA11 6,TA11 6,Total,2901,2794,107
2011,TA11 7,TA11 7,Total,1260,1182,78
2011,TA12 6,TA12 6,Total,2901,2772,129
2011,TA13 5,TA13 5,Total,1917,1819,98
2011,TA14 6,TA14 6,Total,1370,1299,71
2011,TA15 6,TA15 6,Total,389,365,24
2011,TA16 5,TA16 5,Total,882,836,46
2011,TA17 8,TA17 8,Total,267,229,38
2011,TA18 7,TA18 7,Total,1957,1800,157
2011,TA18 8,TA18 8,Total,2866,2719,147
2011,TA19 0,TA19 0,Total,2767,2629,138
2011,TA19 9,TA19 9,Total,2675,2519,156
2011,TA2  6,TA2  6,Total,3406,3291,115
2011,TA2  7,TA2  7,Total,4605,4415,190
2011,TA2  8,TA2  8,Total,3353,3218,135
2011,TA20 1,TA20 1,Total,3586,3410,176
2011,TA20 2,TA20 2,Total,3501,3336,165
2011,TA20 3,TA20 3,Total,1308,1218,90
2011,TA20 4,TA20 4,Total,1077,964,113
2011,TA21 0,TA21 0,Total,1754,1658,96
2011,TA21 8,TA21 8,Total,3305,3114,191
2011,TA21 9,TA21 9,Total,3065,2898,167
2011,TA22 9,TA22 9,Total,1463,1268,195
2011,TA23 0,TA23 0,Total,2793,2550,243
2011,TA24 5,TA24 5,Total,2944,2611,333
2011,TA24 6,TA24 6,Total,2951,2547,404
2011,TA24 7,TA24 7,Total,1007,809,198
2011,TA24 8,TA24 8,Total,2726,2407,319
2011,TA3  5,TA3  5,Total,2560,2448,112
2011,TA3  6,TA3  6,Total,2088,1961,127
2011,TA3  7,TA3  7,Total,1767,1671,96
2011,TA4  1,TA4  1,Total,2210,2136,74
2011,TA4  2,TA4  2,Total,1959,1825,134
2011,TA4  3,TA4  3,Total,2350,2244,106
2011,TA4  4,TA4  4,Total,1926,1787,139
2011,TA5  1,TA5  1,Total,2494,2314,180
2011,TA5  2,TA5  2,Total,2146,1996,150
2011,TA6  3,TA6  3,Total,4608,4351,257
2011,TA6  4,TA6  4,Total,5408,5259,149
2011,TA6  5,TA6  5,Total,2833,2724,109
2011,TA6  6,TA6  6,Total,4704,4555,149
2011,TA6  7,TA6  7,Total,2911,2842,69
2011,TA7  0,TA7  0,Total,2119,2010,109
2011,TA7  8,TA7  8,Total,2627,2542,85
2011,TA7  9,TA7  9,Total,1756,1687,69
2011,TA8  1,TA8  1,Total,3585,3429,156
2011,TA8  2,TA8  2,Total,4553,4294,259
2011,TA9  3,TA9  3,Total,3684,3571,113
2011,TA9  4,TA9  4,Total,1704,1639,65
2011,TD12 4,TD12 4,Total,653,528,125
2011,TD15 1,TD15 1,Total,2812,2535,277
2011,TD15 2,TD15 2,Total,5750,5194,556
2011,TF1  1,TF1  1,Total,1975,1898,77
2011,TF1  2,TF1  2,Total,2929,2854,75
2011,TF1  3,TF1  3,Total,3382,3315,67
2011,TF1  5,TF1  5,Total,3457,3352,105
2011,TF1  6,TF1  6,Total,3684,3615,69
2011,TF10 7,TF10 7,Total,4512,4389,123
2011,TF10 8,TF10 8,Total,1503,1462,41
2011,TF10 9,TF10 9,Total,1388,1330,58
2011,TF11 8,TF11 8,Total,2866,2762,104
2011,TF11 9,TF11 9,Total,1631,1554,77
2011,TF12 5,TF12 5,Total,2529,2419,110
2011,TF13 6,TF13 6,Total,1683,1591,92
2011,TF2  0,TF2  0,Total,1166,1141,25
2011,TF2  6,TF2  6,Total,3009,2921,88
2011,TF2  7,TF2  7,Total,3409,3311,98
2011,TF2  8,TF2  8,Total,4076,3940,136
2011,TF2  9,TF2  9,Total,4477,4367,110
2011,TF3  1,TF3  1,Total,4400,4256,144
2011,TF3  2,TF3  2,Total,3533,3431,102
2011,TF3  5,TF3  5,Total,1517,1498,19
2011,TF4  2,TF4  2,Total,3866,3689,177
2011,TF4  3,TF4  3,Total,3801,3736,65
2011,TF5  0,TF5  0,Total,2003,1968,35
2011,TF6  5,TF6  5,Total,580,567,13
2011,TF6  6,TF6  6,Total,1490,1435,55
2011,TF7  4,TF7  4,Total,2626,2463,163
2011,TF7  5,TF7  5,Total,4888,4698,190
2011,TF8  7,TF8  7,Total,1388,1273,115
2011,TF9  1,TF9  1,Total,2896,2792,104
2011,TF9  2,TF9  2,Total,2303,2182,121
2011,TF9  3,TF9  3,Total,3437,3305,132
2011,TF9  4,TF9  4,Total,1966,1918,48
2011,TN1  1,TN1  1,Total,2126,1980,146
2011,TN1  2,TN1  2,Total,3824,3559,265
2011,TN10 3,TN10 3,Total,3324,3235,89
2011,TN10 4,TN10 4,Total,3455,3384,71
2011,TN11 0,TN11 0,Total,1810,1751,59
2011,TN11 8,TN11 8,Total,1537,1440,97
2011,TN11 9,TN11 9,Total,2354,2236,118
2011,TN12 0,TN12 0,Total,2387,2311,76
2011,TN12 5,TN12 5,Total,1367,1323,44
2011,TN12 6,TN12 6,Total,4209,4072,137
2011,TN12 7,TN12 7,Total,1164,1122,42
2011,TN12 8,TN12 8,Total,944,914,30
2011,TN12 9,TN12 9,Total,1914,1839,75
2011,TN13 1,TN13 1,Total,2170,2098,72
2011,TN13 2,TN13 2,Total,3628,3522,106
2011,TN13 3,TN13 3,Total,4362,4219,143
2011,TN14 5,TN14 5,Total,2784,2735,49
2011,TN14 6,TN14 6,Total,1442,1382,60
2011,TN14 7,TN14 7,Total,2103,2016,87
2011,TN15 0,TN15 0,Total,1759,1664,95
2011,TN15 6,TN15 6,Total,4071,3962,109
2011,TN15 7,TN15 7,Total,1429,1356,73
2011,TN15 8,TN15 8,Total,2155,2072,83
2011,TN15 9,TN15 9,Total,741,708,33
2011,TN16 1,TN16 1,Total,2244,2138,106
2011,TN16 2,TN16 2,Total,1017,974,43
2011,TN16 3,TN16 3,Total,4808,4654,154
2011,TN17 1,TN17 1,Total,960,915,45
2011,TN17 2,TN17 2,Total,1473,1387,86
2011,TN17 3,TN17 3,Total,1920,1846,74
2011,TN17 4,TN17 4,Total,1541,1455,86
2011,TN18 4,TN18 4,Total,1741,1676,65
2011,TN18 5,TN18 5,Total,1030,992,38
2011,TN19 7,TN19 7,Total,2144,2032,112
2011,TN2  3,TN2  3,Total,4357,4198,159
2011,TN2  4,TN2  4,Total,3546,3437,109
2011,TN2  5,TN2  5,Total,4344,4185,159
2011,TN20 6,TN20 6,Total,1719,1608,111
2011,TN21 0,TN21 0,Total,2465,2391,74
2011,TN21 8,TN21 8,Total,3214,3107,107
2011,TN21 9,TN21 9,Total,1289,1222,67
2011,TN22 1,TN22 1,Total,2827,2729,98
2011,TN22 2,TN22 2,Total,1446,1424,22
2011,TN22 3,TN22 3,Total,1767,1674,93
2011,TN22 4,TN22 4,Total,1451,1379,72
2011,TN22 5,TN22 5,Total,3616,3513,103
2011,TN23 1,TN23 1,Total,829,777,52
2011,TN23 3,TN23 3,Total,5193,5067,126
2011,TN23 4,TN23 4,Total,2130,2089,41
2011,TN23 5,TN23 5,Total,5803,5640,163
2011,TN23 6,TN23 6,Total,662,650,12
2011,TN23 7,TN23 7,Total,1280,1219,61
2011,TN24 0,TN24 0,Total,5895,5744,151
2011,TN24 8,TN24 8,Total,2643,2528,115
2011,TN24 9,TN24 9,Total,4773,4635,138
2011,TN25 4,TN25 4,Total,1918,1854,64
2011,TN25 5,TN25 5,Total,1693,1583,110
2011,TN25 6,TN25 6,Total,2107,2048,59
2011,TN25 7,TN25 7,Total,936,852,84
2011,TN26 1,TN26 1,Total,1161,1084,77
2011,TN26 2,TN26 2,Total,1511,1423,88
2011,TN26 3,TN26 3,Total,2187,2070,117
2011,TN27 0,TN27 0,Total,1855,1750,105
2011,TN27 8,TN27 8,Total,1665,1570,95
2011,TN27 9,TN27 9,Total,2050,1912,138
2011,TN28 8,TN28 8,Total,3853,3623,230
2011,TN29 0,TN29 0,Total,3531,3349,182
2011,TN29 9,TN29 9,Total,2803,2668,135
2011,TN3  0,TN3  0,Total,2246,2187,59
2011,TN3  8,TN3  8,Total,702,667,35
2011,TN3  9,TN3  9,Total,1791,1719,72
2011,TN30 6,TN30 6,Total,2681,2546,135
2011,TN30 7,TN30 7,Total,1681,1567,114
2011,TN31 6,TN31 6,Total,3089,2855,234
2011,TN31 7,TN31 7,Total,4006,3359,647
2011,TN32 5,TN32 5,Total,2172,2052,120
2011,TN33 0,TN33 0,Total,3716,3534,182
2011,TN33 9,TN33 9,Total,1851,1766,85
2011,TN34 1,TN34 1,Total,3362,3157,205
2011,TN34 2,TN34 2,Total,5495,5348,147
2011,TN34 3,TN34 3,Total,5905,5530,375
2011,TN35 4,TN35 4,Total,3189,2961,228
2011,TN35 5,TN35 5,Total,4535,4420,115
2011,TN36 4,TN36 4,Total,1332,1122,210
2011,TN37 6,TN37 6,Total,5735,5323,412
2011,TN37 7,TN37 7,Total,4411,4283,128
2011,TN38 0,TN38 0,Total,7243,6808,435
2011,TN38 8,TN38 8,Total,1938,1904,34
2011,TN38 9,TN38 9,Total,4260,4197,63
2011,TN39 3,TN39 3,Total,5563,5129,434
2011,TN39 4,TN39 4,Total,4715,4552,163
2011,TN39 5,TN39 5,Total,2421,2354,67
2011,TN4  0,TN4  0,Total,3723,3619,104
2011,TN4  8,TN4  8,Total,4115,3938,177
2011,TN4  9,TN4  9,Total,5798,5665,133
2011,TN40 1,TN40 1,Total,4493,4028,465
2011,TN40 2,TN40 2,Total,4562,4427,135
2011,TN5  6,TN5  6,Total,2126,2023,103
2011,TN5  7,TN5  7,Total,1608,1519,89
2011,TN6  1,TN6  1,Total,3472,3389,83
2011,TN6  2,TN6  2,Total,4326,4202,124
2011,TN6  3,TN6  3,Total,2384,2298,86
2011,TN7  4,TN7  4,Total,953,893,60
2011,TN8  5,TN8  5,Total,2323,2236,87
2011,TN8  6,TN8  6,Total,2103,2035,68
2011,TN8  7,TN8  7,Total,1073,1018,55
2011,TN9  1,TN9  1,Total,3013,2838,175
2011,TN9  2,TN9  2,Total,4538,4422,116
2011,TQ1  1,TQ1  1,Total,4356,3865,491
2011,TQ1  2,TQ1  2,Total,2845,2370,475
2011,TQ1  3,TQ1  3,Total,4648,4225,423
2011,TQ1  4,TQ1  4,Total,4766,4461,305
2011,TQ10 9,TQ10 9,Total,1885,1703,182
2011,TQ11 0,TQ11 0,Total,1894,1785,109
2011,TQ12 1,TQ12 1,Total,4988,4766,222
2011,TQ12 2,TQ12 2,Total,2626,2470,156
2011,TQ12 3,TQ12 3,Total,4683,4463,220
2011,TQ12 4,TQ12 4,Total,3871,3701,170
2011,TQ12 5,TQ12 5,Total,4047,3844,203
2011,TQ12 6,TQ12 6,Total,3251,3134,117
2011,TQ13 0,TQ13 0,Total,2682,2529,153
2011,TQ13 7,TQ13 7,Total,2550,2366,184
2011,TQ13 8,TQ13 8,Total,1968,1709,259
2011,TQ13 9,TQ13 9,Total,3752,3506,246
2011,TQ14 0,TQ14 0,Total,1097,855,242
2011,TQ14 8,TQ14 8,Total,4142,3683,459
2011,TQ14 9,TQ14 9,Total,4678,4406,272
2011,TQ2  5,TQ2  5,Total,2875,2525,350
2011,TQ2  6,TQ2  6,Total,4664,4366,298
2011,TQ2  7,TQ2  7,Total,4724,4529,195
2011,TQ2  8,TQ2  8,Total,3255,3169,86
2011,TQ3  1,TQ3  1,Total,3696,3560,136
2011,TQ3  2,TQ3  2,Total,4114,3765,349
2011,TQ3  3,TQ3  3,Total,6274,5882,392
2011,TQ4  5,TQ4  5,Total,2978,2754,224
2011,TQ4  6,TQ4  6,Total,2503,2036,467
2011,TQ4  7,TQ4  7,Total,3919,3766,153
2011,TQ5  0,TQ5  0,Total,2804,2650,154
2011,TQ5  8,TQ5  8,Total,2859,2437,422
2011,TQ5  9,TQ5  9,Total,4317,3816,501
2011,TQ6  0,TQ6  0,Total,1849,1422,427
2011,TQ6  9,TQ6  9,Total,3290,2527,763
2011,TQ7  1,TQ7  1,Total,3021,2727,294
2011,TQ7  2,TQ7  2,Total,2408,1834,574
2011,TQ7  3,TQ7  3,Total,2625,1742,883
2011,TQ7  4,TQ7  4,Total,1794,1366,428
2011,TQ8  8,TQ8  8,Total,2087,1035,1052
2011,TQ9  5,TQ9  5,Total,4157,3848,309
2011,TQ9  6,TQ9  6,Total,2161,2013,148
2011,TQ9  7,TQ9  7,Total,2211,1889,322
2011,TR1  1,TR1  1,Total,4126,3909,217
2011,TR1  2,TR1  2,Total,1636,1521,115
2011,TR1  3,TR1  3,Total,3991,3822,169
2011,TR10 8,TR10 8,Total,3342,3146,196
2011,TR10 9,TR10 9,Total,1262,1213,49
2011,TR11 2,TR11 2,Total,3777,3528,249
2011,TR11 3,TR11 3,Total,2230,1956,274
2011,TR11 4,TR11 4,Total,3601,3194,407
2011,TR11 5,TR11 5,Total,4648,3963,685
2011,TR12 6,TR12 6,Total,2292,1800,492
2011,TR12 7,TR12 7,Total,2594,2095,499
2011,TR13 0,TR13 0,Total,1818,1712,106
2011,TR13 8,TR13 8,Total,4428,4272,156
2011,TR13 9,TR13 9,Total,2855,2432,423
2011,TR14 0,TR14 0,Total,2105,1981,124
2011,TR14 7,TR14 7,Total,3834,3713,121
2011,TR14 8,TR14 8,Total,4099,3884,215
2011,TR14 9,TR14 9,Total,1047,989,58
2011,TR15 1,TR15 1,Total,2778,2661,117
2011,TR15 2,TR15 2,Total,2915,2677,238
2011,TR15 3,TR15 3,Total,3514,3374,140
2011,TR16 4,TR16 4,Total,2527,2337,190
2011,TR16 5,TR16 5,Total,2285,2169,116
2011,TR16 6,TR16 6,Total,1621,1524,97
2011,TR17 0,TR17 0,Total,871,684,187
2011,TR18 2,TR18 2,Total,2869,2619,250
2011,TR18 3,TR18 3,Total,2986,2781,205
2011,TR18 4,TR18 4,Total,2736,2439,297
2011,TR18 5,TR18 5,Total,1861,1638,223
2011,TR19 6,TR19 6,Total,2101,1519,582
2011,TR19 7,TR19 7,Total,3146,2595,551
2011,TR2  4,TR2  4,Total,2412,2248,164
2011,TR2  5,TR2  5,Total,2857,1955,902
2011,TR20 8,TR20 8,Total,2198,1994,204
2011,TR20 9,TR20 9,Total,2266,1970,296
2011,TR21 0,TR21 0,Total,1046,772,274
2011,TR22 0,TR22 0,Total,106,68,38
2011,TR24 0,TR24 0,Total,164,95,69
2011,TR25 0,TR25 0,Total,73,54,19
2011,TR26 1,TR26 1,Total,2660,1821,839
2011,TR26 2,TR26 2,Total,3461,2732,729
2011,TR26 3,TR26 3,Total,891,727,164
2011,TR27 4,TR27 4,Total,3293,3130,163
2011,TR27 5,TR27 5,Total,2018,1778,240
2011,TR27 6,TR27 6,Total,1483,1351,132
2011,TR3  6,TR3  6,Total,3700,3451,249
2011,TR3  7,TR3  7,Total,2044,1966,78
2011,TR4  8,TR4  8,Total,2875,2641,234
2011,TR4  9,TR4  9,Total,2161,2020,141
2011,TR5  0,TR5  0,Total,2087,1750,337
2011,TR6  0,TR6  0,Total,1914,1614,300
2011,TR7  1,TR7  1,Total,3585,2771,814
2011,TR7  2,TR7  2,Total,4019,3704,315
2011,TR7  3,TR7  3,Total,2670,2365,305
2011,TR8  4,TR8  4,Total,1714,1392,322
2011,TR8  5,TR8  5,Total,2122,1882,240
2011,TR9  6,TR9  6,Total,3677,3329,348
2011,TS1  1,TS1  1,Total,148,130,18
2011,TS1  2,TS1  2,Total,641,551,90
2011,TS1  3,TS1  3,Total,2124,1910,214
2011,TS1  4,TS1  4,Total,4229,3640,589
2011,TS1  5,TS1  5,Total,806,783,23
2011,TS10 1,TS10 1,Total,3423,3177,246
2011,TS10 2,TS10 2,Total,4681,4586,95
2011,TS10 3,TS10 3,Total,2539,2422,117
2011,TS10 4,TS10 4,Total,4074,3945,129
2011,TS10 5,TS10 5,Total,2142,2075,67
2011,TS11 6,TS11 6,Total,1830,1777,53
2011,TS11 7,TS11 7,Total,2085,2032,53
2011,TS11 8,TS11 8,Total,1627,1588,39
2011,TS12 1,TS12 1,Total,3070,2865,205
2011,TS12 2,TS12 2,Total,5716,5480,236
2011,TS12 3,TS12 3,Total,1725,1635,90
2011,TS13 4,TS13 4,Total,3758,3500,258
2011,TS13 5,TS13 5,Total,1481,1088,393
2011,TS14 6,TS14 6,Total,3359,3222,137
2011,TS14 7,TS14 7,Total,2441,2383,58
2011,TS14 8,TS14 8,Total,2205,2155,50
2011,TS15 0,TS15 0,Total,1103,1049,54
2011,TS15 9,TS15 9,Total,4642,4424,218
2011,TS16 0,TS16 0,Total,3127,3028,99
2011,TS16 9,TS16 9,Total,1376,1310,66
2011,TS17 0,TS17 0,Total,5760,5626,134
2011,TS17 5,TS17 5,Total,3540,3452,88
2011,TS17 6,TS17 6,Total,1927,1810,117
2011,TS17 7,TS17 7,Total,990,929,61
2011,TS17 8,TS17 8,Total,2661,2565,96
2011,TS17 9,TS17 9,Total,3386,3317,69
2011,TS18 1,TS18 1,Total,1277,1114,163
2011,TS18 2,TS18 2,Total,1339,1236,103
2011,TS18 3,TS18 3,Total,2761,2444,317
2011,TS18 4,TS18 4,Total,2699,2589,110
2011,TS18 5,TS18 5,Total,2911,2845,66
2011,TS19 0,TS19 0,Total,5548,5319,229
2011,TS19 7,TS19 7,Total,3896,3825,71
2011,TS19 8,TS19 8,Total,4181,4039,142
2011,TS19 9,TS19 9,Total,2344,2290,54
2011,TS2  1,TS2  1,Total,359,315,44
2011,TS20 1,TS20 1,Total,5245,5056,189
2011,TS20 2,TS20 2,Total,4372,4205,167
2011,TS21 1,TS21 1,Total,1656,1585,71
2011,TS21 2,TS21 2,Total,1333,1299,34
2011,TS21 3,TS21 3,Total,1423,1358,65
2011,TS21 4,TS21 4,Total,1140,1110,30
2011,TS22 5,TS22 5,Total,3676,3538,138
2011,TS23 1,TS23 1,Total,2498,2429,69
2011,TS23 2,TS23 2,Total,3342,3236,106
2011,TS23 3,TS23 3,Total,6258,6098,160
2011,TS23 4,TS23 4,Total,721,699,22
2011,TS24 0,TS24 0,Total,3385,3197,188
2011,TS24 7,TS24 7,Total,681,656,25
2011,TS24 8,TS24 8,Total,2866,2713,153
2011,TS24 9,TS24 9,Total,3517,3383,134
2011,TS25 1,TS25 1,Total,4067,3936,131
2011,TS25 2,TS25 2,Total,3520,3463,57
2011,TS25 3,TS25 3,Total,2609,2518,91
2011,TS25 4,TS25 4,Total,2610,2556,54
2011,TS25 5,TS25 5,Total,4852,4675,177
2011,TS26 0,TS26 0,Total,5507,5296,211
2011,TS26 8,TS26 8,Total,2924,2721,203
2011,TS26 9,TS26 9,Total,3102,2927,175
2011,TS27 3,TS27 3,Total,2287,2220,67
2011,TS27 4,TS27 4,Total,3283,3147,136
2011,TS28 5,TS28 5,Total,2358,2259,99
2011,TS29 6,TS29 6,Total,2794,2690,104
2011,TS3  0,TS3  0,Total,3368,3227,141
2011,TS3  6,TS3  6,Total,1722,1498,224
2011,TS3  7,TS3  7,Total,3011,2911,100
2011,TS3  8,TS3  8,Total,1796,1758,38
2011,TS3  9,TS3  9,Total,3233,3137,96
2011,TS4  2,TS4  2,Total,3661,3437,224
2011,TS4  3,TS4  3,Total,3828,3562,266
2011,TS5  4,TS5  4,Total,2412,2328,84
2011,TS5  5,TS5  5,Total,3225,3066,159
2011,TS5  6,TS5  6,Total,3316,3161,155
2011,TS5  7,TS5  7,Total,2697,2631,66
2011,TS5  8,TS5  8,Total,4969,4839,130
2011,TS6  0,TS6  0,Total,4561,4458,103
2011,TS6  6,TS6  6,Total,1434,1377,57
2011,TS6  7,TS6  7,Total,2017,1938,79
2011,TS6  8,TS6  8,Total,1276,1240,36
2011,TS6  9,TS6  9,Total,4397,4282,115
2011,TS7  0,TS7  0,Total,2778,2663,115
2011,TS7  8,TS7  8,Total,4182,4065,117
2011,TS7  9,TS7  9,Total,2768,2704,64
2011,TS8  0,TS8  0,Total,4118,4047,71
2011,TS8  9,TS8  9,Total,4966,4843,123
2011,TS9  5,TS9  5,Total,2485,2375,110
2011,TS9  6,TS9  6,Total,2564,2446,118
2011,TS9  7,TS9  7,Total,1023,959,64
2011,TW1  1,TW1  1,Total,3600,3472,128
2011,TW1  2,TW1  2,Total,2981,2843,138
2011,TW1  3,TW1  3,Total,1768,1714,54
2011,TW1  4,TW1  4,Total,3011,2927,84
2011,TW10 5,TW10 5,Total,1407,1359,48
2011,TW10 6,TW10 6,Total,4124,3909,215
2011,TW10 7,TW10 7,Total,3280,3210,70
2011,TW11 0,TW11 0,Total,2938,2835,103
2011,TW11 8,TW11 8,Total,3904,3778,126
2011,TW11 9,TW11 9,Total,3641,3478,163
2011,TW12 1,TW12 1,Total,3000,2911,89
2011,TW12 2,TW12 2,Total,4007,3887,120
2011,TW12 3,TW12 3,Total,2975,2916,59
2011,TW13 4,TW13 4,Total,4948,4875,73
2011,TW13 5,TW13 5,Total,3446,3383,63
2011,TW13 6,TW13 6,Total,3398,3339,59
2011,TW13 7,TW13 7,Total,2407,2353,54
2011,TW14 0,TW14 0,Total,2235,2187,48
2011,TW14 8,TW14 8,Total,3940,3780,160
2011,TW14 9,TW14 9,Total,4534,4449,85
2011,TW15 1,TW15 1,Total,4420,4300,120
2011,TW15 2,TW15 2,Total,3451,3290,161
2011,TW15 3,TW15 3,Total,3553,3447,106
2011,TW16 5,TW16 5,Total,2164,2089,75
2011,TW16 6,TW16 6,Total,2383,2247,136
2011,TW16 7,TW16 7,Total,3902,3806,96
2011,TW17 0,TW17 0,Total,2223,2181,42
2011,TW17 8,TW17 8,Total,2966,2845,121
2011,TW17 9,TW17 9,Total,1270,1193,77
2011,TW18 1,TW18 1,Total,3620,3548,72
2011,TW18 2,TW18 2,Total,3560,3399,161
2011,TW18 3,TW18 3,Total,1943,1865,78
2011,TW18 4,TW18 4,Total,2410,2313,97
2011,TW19 5,TW19 5,Total,1678,1556,122
2011,TW19 6,TW19 6,Total,583,550,33
2011,TW19 7,TW19 7,Total,4460,4323,137
2011,TW2  5,TW2  5,Total,4060,3975,85
2011,TW2  6,TW2  6,Total,4319,4231,88
2011,TW2  7,TW2  7,Total,4271,4173,98
2011,TW20 0,TW20 0,Total,3442,3225,217
2011,TW20 8,TW20 8,Total,3253,3152,101
2011,TW20 9,TW20 9,Total,2983,2817,166
2011,TW3  1,TW3  1,Total,3124,3050,74
2011,TW3  2,TW3  2,Total,3627,3564,63
2011,TW3  3,TW3  3,Total,4316,4208,108
2011,TW3  4,TW3  4,Total,2932,2864,68
2011,TW4  5,TW4  5,Total,3510,3450,60
2011,TW4  6,TW4  6,Total,1827,1790,37
2011,TW4  7,TW4  7,Total,3710,3646,64
2011,TW5  0,TW5  0,Total,4597,4538,59
2011,TW5  9,TW5  9,Total,4901,4823,78
2011,TW7  4,TW7  4,Total,3125,3076,49
2011,TW7  5,TW7  5,Total,3396,3304,92
2011,TW7  6,TW7  6,Total,4314,4222,92
2011,TW7  7,TW7  7,Total,3903,3848,55
2011,TW8  0,TW8  0,Total,4217,4085,132
2011,TW8  8,TW8  8,Total,2373,2286,87
2011,TW8  9,TW8  9,Total,2235,2190,45
2011,TW9  1,TW9  1,Total,2311,2152,159
2011,TW9  2,TW9  2,Total,3162,3035,127
2011,TW9  3,TW9  3,Total,2192,2042,150
2011,TW9  4,TW9  4,Total,2817,2721,96
2011,UB1  1,UB1  1,Total,3005,2766,239
2011,UB1  2,UB1  2,Total,5948,5714,234
2011,UB1  3,UB1  3,Total,3047,2948,99
2011,UB10 0,UB10 0,Total,4299,4015,284
2011,UB10 8,UB10 8,Total,4828,4649,179
2011,UB10 9,UB10 9,Total,3915,3802,113
2011,UB2  4,UB2  4,Total,4224,4045,179
2011,UB2  5,UB2  5,Total,5812,5569,243
2011,UB3  1,UB3  1,Total,3277,3212,65
2011,UB3  2,UB3  2,Total,4741,4651,90
2011,UB3  3,UB3  3,Total,2615,2549,66
2011,UB3  4,UB3  4,Total,3308,3225,83
2011,UB3  5,UB3  5,Total,2372,2286,86
2011,UB4  0,UB4  0,Total,4497,4347,150
2011,UB4  8,UB4  8,Total,4624,4475,149
2011,UB4  9,UB4  9,Total,4658,4504,154
2011,UB5  4,UB5  4,Total,5844,5729,115
2011,UB5  5,UB5  5,Total,4968,4841,127
2011,UB5  6,UB5  6,Total,6376,6257,119
2011,UB6  0,UB6  0,Total,4191,4096,95
2011,UB6  7,UB6  7,Total,2992,2920,72
2011,UB6  8,UB6  8,Total,5348,5199,149
2011,UB6  9,UB6  9,Total,5439,5274,165
2011,UB7  0,UB7  0,Total,1499,1358,141
2011,UB7  7,UB7  7,Total,3847,3619,228
2011,UB7  8,UB7  8,Total,2796,2727,69
2011,UB7  9,UB7  9,Total,3536,3390,146
2011,UB8  1,UB8  1,Total,2386,2247,139
2011,UB8  2,UB8  2,Total,4819,4641,178
2011,UB8  3,UB8  3,Total,6061,5933,128
2011,UB9  4,UB9  4,Total,996,942,54
2011,UB9  5,UB9  5,Total,2238,2124,114
2011,UB9  6,UB9  6,Total,3132,3008,124
2011,W10  4,W10  4,Total,4286,4165,121
2011,W10  5,W10  5,Total,5436,5345,91
2011,W10  6,W10  6,Total,5546,5354,192
2011,W11  1,W11  1,Total,5344,5142,202
2011,W11  2,W11  2,Total,3957,3607,350
2011,W11  3,W11  3,Total,2566,2256,310
2011,W11  4,W11  4,Total,4481,4279,202
2011,W12  0,W12  0,Total,5839,5691,148
2011,W12  7,W12  7,Total,4605,4473,132
2011,W12  8,W12  8,Total,4389,4229,160
2011,W12  9,W12  9,Total,6143,5952,191
2011,W13  0,W13  0,Total,4405,4290,115
2011,W13  8,W13  8,Total,3230,3128,102
2011,W13  9,W13  9,Total,6115,5954,161
2011,W14  0,W14  0,Total,5800,5529,271
2011,W14  8,W14  8,Total,6042,5465,577
2011,W14  9,W14  9,Total,7058,6788,270
2011,W1B  1,W1B  1,Total,334,270,64
2011,W1D  3,W1D  3,Total,174,136,38
2011,W1D  4,W1D  4,Total,259,234,25
2011,W1D  6,W1D  6,Total,412,348,64
2011,W1D  7,W1D  7,Total,212,144,68
2011,W1F  0,W1F  0,Total,641,581,60
2011,W1F  7,W1F  7,Total,404,341,63
2011,W1G  6,W1G  6,Total,522,428,94
2011,W1G  7,W1G  7,Total,215,167,48
2011,W1G  8,W1G  8,Total,920,781,139
2011,W1G  9,W1G  9,Total,211,168,43
2011,W1H  1,W1H  1,Total,664,602,62
2011,W1H  2,W1H  2,Total,1145,937,208
2011,W1H  4,W1H  4,Total,479,436,43
2011,W1H  5,W1H  5,Total,779,538,241
2011,W1H  7,W1H  7,Total,977,748,229
2011,W1J  5,W1J  5,Total,325,145,180
2011,W1J  6,W1J  6,Total,128,104,24
2011,W1J  7,W1J  7,Total,679,451,228
2011,W1J  8,W1J  8,Total,300,190,110
2011,W1K  1,W1K  1,Total,336,173,163
2011,W1K  2,W1K  2,Total,518,310,208
2011,W1K  3,W1K  3,Total,210,154,56
2011,W1K  4,W1K  4,Total,85,78,7
2011,W1K  5,W1K  5,Total,163,148,15
2011,W1K  6,W1K  6,Total,568,484,84
2011,W1K  7,W1K  7,Total,467,314,153
2011,W1S  1,W1S  1,Total,135,104,31
2011,W1T  1,W1T  1,Total,309,282,27
2011,W1T  2,W1T  2,Total,378,345,33
2011,W1T  3,W1T  3,Total,160,138,22
2011,W1T  4,W1T  4,Total,257,228,29
2011,W1T  5,W1T  5,Total,654,596,58
2011,W1T  6,W1T  6,Total,164,144,20
2011,W1U  1,W1U  1,Total,314,213,101
2011,W1U  2,W1U  2,Total,177,145,32
2011,W1U  3,W1U  3,Total,372,286,86
2011,W1U  4,W1U  4,Total,804,684,120
2011,W1U  5,W1U  5,Total,693,623,70
2011,W1U  6,W1U  6,Total,908,716,192
2011,W1U  8,W1U  8,Total,462,382,80
2011,W1W  5,W1W  5,Total,783,691,92
2011,W1W  6,W1W  6,Total,1116,994,122
2011,W1W  7,W1W  7,Total,539,485,54
2011,W2   1,W2   1,Total,3671,3248,423
2011,W2   2,W2   2,Total,3775,2967,808
2011,W2   3,W2   3,Total,4605,3981,624
2011,W2   4,W2   4,Total,4747,4300,447
2011,W2   5,W2   5,Total,5493,5251,242
2011,W2   6,W2   6,Total,4459,4183,276
2011,W3   0,W3   0,Total,2413,2322,91
2011,W3   6,W3   6,Total,5600,5384,216
2011,W3   7,W3   7,Total,5769,5493,276
2011,W3   8,W3   8,Total,4564,4446,118
2011,W3   9,W3   9,Total,3387,3272,115
2011,W4   1,W4   1,Total,3711,3551,160
2011,W4   2,W4   2,Total,4653,4491,162
2011,W4   3,W4   3,Total,5289,5107,182
2011,W4   4,W4   4,Total,2642,2491,151
2011,W4   5,W4   5,Total,4299,4093,206
2011,W5   1,W5   1,Total,4034,3948,86
2011,W5   2,W5   2,Total,4665,4484,181
2011,W5   3,W5   3,Total,4368,4170,198
2011,W5   4,W5   4,Total,5859,5696,163
2011,W5   5,W5   5,Total,2289,2213,76
2011,W6   0,W6   0,Total,5682,5446,236
2011,W6   7,W6   7,Total,2831,2713,118
2011,W6   8,W6   8,Total,4006,3928,78
2011,W6   9,W6   9,Total,3953,3793,160
2011,W7   1,W7   1,Total,3759,3684,75
2011,W7   2,W7   2,Total,3058,2979,79
2011,W7   3,W7   3,Total,4617,4473,144
2011,W8   4,W8   4,Total,2130,1831,299
2011,W8   5,W8   5,Total,2575,2190,385
2011,W8   6,W8   6,Total,3181,2832,349
2011,W8   7,W8   7,Total,3054,2635,419
2011,W9   1,W9   1,Total,6591,6117,474
2011,W9   2,W9   2,Total,5541,5358,183
2011,W9   3,W9   3,Total,6191,6028,163
2011,WA1  1,WA1  1,Total,489,423,66
2011,WA1  2,WA1  2,Total,1104,1063,41
2011,WA1  3,WA1  3,Total,4643,4502,141
2011,WA1  4,WA1  4,Total,3407,3332,75
2011,WA10 1,WA10 1,Total,1359,1205,154
2011,WA10 2,WA10 2,Total,2590,2396,194
2011,WA10 3,WA10 3,Total,4382,4168,214
2011,WA10 4,WA10 4,Total,3842,3701,141
2011,WA10 5,WA10 5,Total,2721,2643,78
2011,WA10 6,WA10 6,Total,3406,3271,135
2011,WA11 0,WA11 0,Total,7223,6949,274
2011,WA11 7,WA11 7,Total,3078,2958,120
2011,WA11 8,WA11 8,Total,2715,2608,107
2011,WA11 9,WA11 9,Total,5110,4957,153
2011,WA12 0,WA12 0,Total,1900,1831,69
2011,WA12 8,WA12 8,Total,3453,3330,123
2011,WA12 9,WA12 9,Total,4634,4411,223
2011,WA13 0,WA13 0,Total,2943,2838,105
2011,WA13 9,WA13 9,Total,2634,2560,74
2011,WA14 1,WA14 1,Total,1586,1497,89
2011,WA14 2,WA14 2,Total,2712,2539,173
2011,WA14 3,WA14 3,Total,1742,1679,63
2011,WA14 4,WA14 4,Total,3044,2926,118
2011,WA14 5,WA14 5,Total,3252,3143,109
2011,WA15 0,WA15 0,Total,1895,1793,102
2011,WA15 6,WA15 6,Total,5148,5024,124
2011,WA15 7,WA15 7,Total,4459,4339,120
2011,WA15 8,WA15 8,Total,3708,3603,105
2011,WA15 9,WA15 9,Total,2382,2309,73
2011,WA16 0,WA16 0,Total,2727,2616,111
2011,WA16 6,WA16 6,Total,1435,1363,72
2011,WA16 7,WA16 7,Total,1513,1421,92
2011,WA16 8,WA16 8,Total,3492,3371,121
2011,WA16 9,WA16 9,Total,1595,1535,60
2011,WA2  0,WA2  0,Total,7596,7456,140
2011,WA2  7,WA2  7,Total,4070,3829,241
2011,WA2  8,WA2  8,Total,2425,2327,98
2011,WA2  9,WA2  9,Total,4313,4203,110
2011,WA3  1,WA3  1,Total,1489,1414,75
2011,WA3  2,WA3  2,Total,4184,4106,78
2011,WA3  3,WA3  3,Total,4560,4404,156
2011,WA3  4,WA3  4,Total,1984,1926,58
2011,WA3  5,WA3  5,Total,2031,1933,98
2011,WA3  6,WA3  6,Total,4448,4323,125
2011,WA3  7,WA3  7,Total,2014,1954,60
2011,WA4  1,WA4  1,Total,4846,4643,203
2011,WA4  2,WA4  2,Total,5711,5545,166
2011,WA4  3,WA4  3,Total,1782,1726,56
2011,WA4  4,WA4  4,Total,1288,1222,66
2011,WA4  5,WA4  5,Total,2895,2823,72
2011,WA4  6,WA4  6,Total,4168,3980,188
2011,WA5  0,WA5  0,Total,2637,2513,124
2011,WA5  1,WA5  1,Total,5829,5636,193
2011,WA5  2,WA5  2,Total,4240,4121,119
2011,WA5  3,WA5  3,Total,4337,4276,61
2011,WA5  4,WA5  4,Total,1711,1643,68
2011,WA5  7,WA5  7,Total,622,610,12
2011,WA5  8,WA5  8,Total,2670,2592,78
2011,WA5  9,WA5  9,Total,2289,2243,46
2011,WA6  0,WA6  0,Total,1737,1665,72
2011,WA6  6,WA6  6,Total,2068,1966,102
2011,WA6  7,WA6  7,Total,2589,2502,87
2011,WA6  8,WA6  8,Total,1037,999,38
2011,WA6  9,WA6  9,Total,1096,1041,55
2011,WA7  1,WA7  1,Total,2809,2682,127
2011,WA7  2,WA7  2,Total,6926,6828,98
2011,WA7  3,WA7  3,Total,1562,1530,32
2011,WA7  4,WA7  4,Total,4102,4000,102
2011,WA7  5,WA7  5,Total,5596,5482,114
2011,WA7  6,WA7  6,Total,6480,6381,99
2011,WA8  0,WA8  0,Total,1579,1495,84
2011,WA8  3,WA8  3,Total,2893,2809,84
2011,WA8  4,WA8  4,Total,3109,3040,69
2011,WA8  5,WA8  5,Total,924,885,39
2011,WA8  6,WA8  6,Total,3472,3335,137
2011,WA8  7,WA8  7,Total,4576,4459,117
2011,WA8  8,WA8  8,Total,5416,5271,145
2011,WA8  9,WA8  9,Total,4954,4822,132
2011,WA9  1,WA9  1,Total,2445,2219,226
2011,WA9  2,WA9  2,Total,3104,2945,159
2011,WA9  3,WA9  3,Total,5198,4884,314
2011,WA9  4,WA9  4,Total,5959,5738,221
2011,WA9  5,WA9  5,Total,5216,4977,239
2011,WC1A 1,WC1A 1,Total,134,128,6
2011,WC1A 2,WC1A 2,Total,168,142,26
2011,WC1B 3,WC1B 3,Total,475,430,45
2011,WC1B 4,WC1B 4,Total,316,276,40
2011,WC1E 6,WC1E 6,Total,472,443,29
2011,WC1E 7,WC1E 7,Total,385,339,46
2011,WC1H 0,WC1H 0,Total,829,663,166
2011,WC1H 8,WC1H 8,Total,1161,1140,21
2011,WC1H 9,WC1H 9,Total,2059,1747,312
2011,WC1N 1,WC1N 1,Total,1565,1499,66
2011,WC1N 2,WC1N 2,Total,811,730,81
2011,WC1N 3,WC1N 3,Total,1168,1126,42
2011,WC1R 4,WC1R 4,Total,400,360,40
2011,WC1V 6,WC1V 6,Total,273,216,57
2011,WC1V 7,WC1V 7,Total,132,125,7
2011,WC1X 0,WC1X 0,Total,1313,1266,47
2011,WC1X 8,WC1X 8,Total,211,194,17
2011,WC1X 9,WC1X 9,Total,1755,1643,112
2011,WC2B 4,WC2B 4,Total,374,348,26
2011,WC2B 5,WC2B 5,Total,707,626,81
2011,WC2E 7,WC2E 7,Total,435,362,73
2011,WC2E 9,WC2E 9,Total,248,170,78
2011,WC2H 0,WC2H 0,Total,503,460,43
2011,WC2H 7,WC2H 7,Total,141,132,9
2011,WC2H 8,WC2H 8,Total,148,117,31
2011,WC2H 9,WC2H 9,Total,648,575,73
2011,WC2N 4,WC2N 4,Total,190,153,37
2011,WC2N 5,WC2N 5,Total,207,141,66
2011,WC2N 6,WC2N 6,Total,240,164,76
2011,WD17 1,WD17 1,Total,643,605,38
2011,WD17 2,WD17 2,Total,1669,1595,74
2011,WD17 3,WD17 3,Total,1453,1409,44
2011,WD17 4,WD17 4,Total,3261,3173,88
2011,WD18 0,WD18 0,Total,3336,3203,133
2011,WD18 6,WD18 6,Total,2056,2028,28
2011,WD18 7,WD18 7,Total,4172,4054,118
2011,WD18 8,WD18 8,Total,289,284,5
2011,WD19 4,WD19 4,Total,3993,3899,94
2011,WD19 5,WD19 5,Total,2179,2116,63
2011,WD19 6,WD19 6,Total,2894,2819,75
2011,WD19 7,WD19 7,Total,2422,2376,46
2011,WD23 1,WD23 1,Total,2599,2480,119
2011,WD23 2,WD23 2,Total,3238,3162,76
2011,WD23 3,WD23 3,Total,2259,2202,57
2011,WD23 4,WD23 4,Total,2572,2497,75
2011,WD24 4,WD24 4,Total,1862,1813,49
2011,WD24 5,WD24 5,Total,2932,2876,56
2011,WD24 6,WD24 6,Total,1790,1763,27
2011,WD24 7,WD24 7,Total,2260,2230,30
2011,WD25 0,WD25 0,Total,3304,3240,64
2011,WD25 7,WD25 7,Total,3378,3330,48
2011,WD25 8,WD25 8,Total,561,534,27
2011,WD25 9,WD25 9,Total,4162,4098,64
2011,WD3  1,WD3  1,Total,2209,2089,120
2011,WD3  3,WD3  3,Total,4690,4593,97
2011,WD3  4,WD3  4,Total,1336,1266,70
2011,WD3  5,WD3  5,Total,3004,2899,105
2011,WD3  6,WD3  6,Total,526,501,25
2011,WD3  7,WD3  7,Total,1370,1335,35
2011,WD3  8,WD3  8,Total,2629,2583,46
2011,WD3  9,WD3  9,Total,1070,1047,23
2011,WD4  8,WD4  8,Total,3428,3341,87
2011,WD4  9,WD4  9,Total,1428,1385,43
2011,WD5  0,WD5  0,Total,4884,4790,94
2011,WD6  1,WD6  1,Total,2984,2916,68
2011,WD6  2,WD6  2,Total,3684,3574,110
2011,WD6  3,WD6  3,Total,1937,1862,75
2011,WD6  4,WD6  4,Total,3490,3418,72
2011,WD6  5,WD6  5,Total,3121,3036,85
2011,WD7  7,WD7  7,Total,1147,1102,45
2011,WD7  8,WD7  8,Total,2135,2041,94
2011,WD7  9,WD7  9,Total,1643,1606,37
2011,WF1  1,WF1  1,Total,877,800,77
2011,WF1  2,WF1  2,Total,3313,3179,134
2011,WF1  3,WF1  3,Total,3768,3467,301
2011,WF1  4,WF1  4,Total,4742,4426,316
2011,WF1  5,WF1  5,Total,3270,2962,308
2011,WF10 1,WF10 1,Total,1243,1155,88
2011,WF10 2,WF10 2,Total,3875,3721,154
2011,WF10 3,WF10 3,Total,5438,5314,124
2011,WF10 4,WF10 4,Total,5020,4797,223
2011,WF10 5,WF10 5,Total,4861,4632,229
2011,WF11 0,WF11 0,Total,2612,2522,90
2011,WF11 8,WF11 8,Total,3029,2924,105
2011,WF11 9,WF11 9,Total,2172,2085,87
2011,WF12 0,WF12 0,Total,4013,3905,108
2011,WF12 7,WF12 7,Total,3570,3441,129
2011,WF12 8,WF12 8,Total,2879,2784,95
2011,WF12 9,WF12 9,Total,2843,2752,91
2011,WF13 1,WF13 1,Total,671,619,52
2011,WF13 2,WF13 2,Total,2622,2463,159
2011,WF13 3,WF13 3,Total,3856,3665,191
2011,WF13 4,WF13 4,Total,3369,3213,156
2011,WF14 0,WF14 0,Total,3137,3039,98
2011,WF14 8,WF14 8,Total,1883,1796,87
2011,WF14 9,WF14 9,Total,3812,3685,127
2011,WF15 6,WF15 6,Total,2356,2260,96
2011,WF15 7,WF15 7,Total,3412,3296,116
2011,WF15 8,WF15 8,Total,2205,2129,76
2011,WF16 0,WF16 0,Total,1980,1861,119
2011,WF16 9,WF16 9,Total,3044,2930,114
2011,WF17 0,WF17 0,Total,3443,3331,112
2011,WF17 5,WF17 5,Total,1357,1272,85
2011,WF17 6,WF17 6,Total,2773,2610,163
2011,WF17 7,WF17 7,Total,4160,3990,170
2011,WF17 8,WF17 8,Total,2807,2683,124
2011,WF17 9,WF17 9,Total,2773,2574,199
2011,WF2  0,WF2  0,Total,4835,4726,109
2011,WF2  6,WF2  6,Total,3586,3464,122
2011,WF2  7,WF2  7,Total,3746,3609,137
2011,WF2  8,WF2  8,Total,6004,5829,175
2011,WF2  9,WF2  9,Total,4106,3864,242
2011,WF3  1,WF3  1,Total,4699,4591,108
2011,WF3  2,WF3  2,Total,2301,2231,70
2011,WF3  3,WF3  3,Total,3732,3630,102
2011,WF3  4,WF3  4,Total,3365,3245,120
2011,WF4  1,WF4  1,Total,3775,3632,143
2011,WF4  2,WF4  2,Total,2908,2794,114
2011,WF4  3,WF4  3,Total,4106,3972,134
2011,WF4  4,WF4  4,Total,3824,3679,145
2011,WF4  5,WF4  5,Total,2264,2194,70
2011,WF4  6,WF4  6,Total,2306,2218,88
2011,WF5  0,WF5  0,Total,4001,3895,106
2011,WF5  8,WF5  8,Total,2773,2695,78
2011,WF5  9,WF5  9,Total,2849,2764,85
2011,WF6  1,WF6  1,Total,5231,4934,297
2011,WF6  2,WF6  2,Total,4478,4301,177
2011,WF7  5,WF7  5,Total,3244,3069,175
2011,WF7  6,WF7  6,Total,2846,2707,139
2011,WF7  7,WF7  7,Total,3068,2927,141
2011,WF8  1,WF8  1,Total,2205,2093,112
2011,WF8  2,WF8  2,Total,6083,5918,165
2011,WF8  3,WF8  3,Total,2709,2619,90
2011,WF8  4,WF8  4,Total,3595,3420,175
2011,WF9  1,WF9  1,Total,2981,2865,116
2011,WF9  2,WF9  2,Total,4713,4538,175
2011,WF9  3,WF9  3,Total,3684,3553,131
2011,WF9  4,WF9  4,Total,4088,3931,157
2011,WF9  5,WF9  5,Total,1962,1863,99
2011,WN1  1,WN1  1,Total,350,322,28
2011,WN1  2,WN1  2,Total,4585,4269,316
2011,WN1  3,WN1  3,Total,4737,4568,169
2011,WN2  1,WN2  1,Total,3802,3696,106
2011,WN2  2,WN2  2,Total,3557,3410,147
2011,WN2  3,WN2  3,Total,4146,3905,241
2011,WN2  4,WN2  4,Total,6660,6453,207
2011,WN2  5,WN2  5,Total,4979,4688,291
2011,WN3  4,WN3  4,Total,2508,2390,118
2011,WN3  5,WN3  5,Total,5237,5103,134
2011,WN3  6,WN3  6,Total,5014,4914,100
2011,WN4  0,WN4  0,Total,4255,4124,131
2011,WN4  8,WN4  8,Total,3644,3556,88
2011,WN4  9,WN4  9,Total,4456,4319,137
2011,WN5  0,WN5  0,Total,3917,3779,138
2011,WN5  7,WN5  7,Total,4964,4828,136
2011,WN5  8,WN5  8,Total,5008,4866,142
2011,WN5  9,WN5  9,Total,5634,5435,199
2011,WN6  0,WN6  0,Total,5654,5489,165
2011,WN6  7,WN6  7,Total,4364,4168,196
2011,WN6  8,WN6  8,Total,5140,4998,142
2011,WN6  9,WN6  9,Total,2207,2130,77
2011,WN7  1,WN7  1,Total,4421,4149,272
2011,WN7  2,WN7  2,Total,4562,4410,152
2011,WN7  3,WN7  3,Total,4575,4440,135
2011,WN7  4,WN7  4,Total,3382,3221,161
2011,WN7  5,WN7  5,Total,4848,4670,178
2011,WN8  0,WN8  0,Total,2678,2578,100
2011,WN8  6,WN8  6,Total,6910,6607,303
2011,WN8  7,WN8  7,Total,1838,1760,78
2011,WN8  8,WN8  8,Total,4660,4468,192
2011,WN8  9,WN8  9,Total,3674,3510,164
2011,WR1  1,WR1  1,Total,2012,1881,131
2011,WR1  2,WR1  2,Total,1130,1041,89
2011,WR1  3,WR1  3,Total,1972,1809,163
2011,WR10 1,WR10 1,Total,3328,3205,123
2011,WR10 2,WR10 2,Total,2630,2502,128
2011,WR10 3,WR10 3,Total,2166,2016,150
2011,WR11 1,WR11 1,Total,2934,2854,80
2011,WR11 2,WR11 2,Total,2891,2791,100
2011,WR11 3,WR11 3,Total,1791,1702,89
2011,WR11 4,WR11 4,Total,3820,3584,236
2011,WR11 7,WR11 7,Total,3653,3502,151
2011,WR11 8,WR11 8,Total,3257,2948,309
2011,WR12 7,WR12 7,Total,2939,2572,367
2011,WR13 5,WR13 5,Total,1557,1488,69
2011,WR13 6,WR13 6,Total,2102,1985,117
2011,WR14 1,WR14 1,Total,5382,5158,224
2011,WR14 2,WR14 2,Total,4996,4820,176
2011,WR14 3,WR14 3,Total,2862,2679,183
2011,WR14 4,WR14 4,Total,2542,2378,164
2011,WR15 8,WR15 8,Total,3233,3073,160
2011,WR2  4,WR2  4,Total,4275,4163,112
2011,WR2  5,WR2  5,Total,4901,4767,134
2011,WR2  6,WR2  6,Total,3274,3199,75
2011,WR3  7,WR3  7,Total,4807,4676,131
2011,WR3  8,WR3  8,Total,4233,4100,133
2011,WR4  0,WR4  0,Total,4216,4156,60
2011,WR4  9,WR4  9,Total,6821,6683,138
2011,WR5  1,WR5  1,Total,4153,4021,132
2011,WR5  2,WR5  2,Total,3548,3436,112
2011,WR5  3,WR5  3,Total,5611,5414,197
2011,WR6  5,WR6  5,Total,2251,2133,118
2011,WR6  6,WR6  6,Total,3041,2874,167
2011,WR7  4,WR7  4,Total,2090,1998,92
2011,WR8  0,WR8  0,Total,2769,2633,136
2011,WR8  9,WR8  9,Total,1201,1133,68
2011,WR9  0,WR9  0,Total,2540,2369,171
2011,WR9  7,WR9  7,Total,4203,4029,174
2011,WR9  8,WR9  8,Total,5210,5062,148
2011,WR9  9,WR9  9,Total,1825,1745,80
2011,WS1  1,WS1  1,Total,290,273,17
2011,WS1  2,WS1  2,Total,3412,3263,149
2011,WS1  3,WS1  3,Total,3275,3092,183
2011,WS1  4,WS1  4,Total,3403,3249,154
2011,WS10 0,WS10 0,Total,5781,5606,175
2011,WS10 7,WS10 7,Total,2719,2549,170
2011,WS10 8,WS10 8,Total,4988,4913,75
2011,WS10 9,WS10 9,Total,5300,5109,191
2011,WS11 0,WS11 0,Total,1974,1873,101
2011,WS11 1,WS11 1,Total,4100,3959,141
2011,WS11 4,WS11 4,Total,1855,1802,53
2011,WS11 5,WS11 5,Total,3337,3222,115
2011,WS11 6,WS11 6,Total,1805,1752,53
2011,WS11 7,WS11 7,Total,1668,1646,22
2011,WS11 8,WS11 8,Total,775,749,26
2011,WS11 9,WS11 9,Total,3168,3090,78
2011,WS12 0,WS12 0,Total,1302,1277,25
2011,WS12 1,WS12 1,Total,2249,2172,77
2011,WS12 2,WS12 2,Total,2553,2498,55
2011,WS12 3,WS12 3,Total,2030,1988,42
2011,WS12 4,WS12 4,Total,6608,6461,147
2011,WS13 6,WS13 6,Total,4289,4004,285
2011,WS13 7,WS13 7,Total,4744,4585,159
2011,WS13 8,WS13 8,Total,2685,2587,98
2011,WS14 0,WS14 0,Total,1844,1768,76
2011,WS14 9,WS14 9,Total,5226,5020,206
2011,WS15 1,WS15 1,Total,4297,4174,123
2011,WS15 2,WS15 2,Total,6333,6172,161
2011,WS15 3,WS15 3,Total,1774,1684,90
2011,WS15 4,WS15 4,Total,3293,3130,163
2011,WS2  0,WS2  0,Total,3507,3442,65
2011,WS2  7,WS2  7,Total,3262,3176,86
2011,WS2  8,WS2  8,Total,4130,3969,161
2011,WS2  9,WS2  9,Total,4452,4211,241
2011,WS3  1,WS3  1,Total,4841,4718,123
2011,WS3  2,WS3  2,Total,5928,5745,183
2011,WS3  3,WS3  3,Total,5846,5674,172
2011,WS3  4,WS3  4,Total,3839,3759,80
2011,WS3  5,WS3  5,Total,860,837,23
2011,WS4  1,WS4  1,Total,5255,5164,91
2011,WS4  2,WS4  2,Total,2054,1976,78
2011,WS5  3,WS5  3,Total,3779,3683,96
2011,WS5  4,WS5  4,Total,4523,4367,156
2011,WS6  6,WS6  6,Total,3924,3845,79
2011,WS6  7,WS6  7,Total,3477,3427,50
2011,WS7  0,WS7  0,Total,1739,1672,67
2011,WS7  1,WS7  1,Total,2199,2127,72
2011,WS7  2,WS7  2,Total,2415,2331,84
2011,WS7  3,WS7  3,Total,641,619,22
2011,WS7  4,WS7  4,Total,3159,3040,119
2011,WS7  9,WS7  9,Total,2585,2504,81
2011,WS8  6,WS8  6,Total,2584,2495,89
2011,WS8  7,WS8  7,Total,3962,3894,68
2011,WS9  0,WS9  0,Total,3889,3798,91
2011,WS9  8,WS9  8,Total,4166,4033,133
2011,WS9  9,WS9  9,Total,3620,3517,103
2011,WV1  1,WV1  1,Total,681,619,62
2011,WV1  2,WV1  2,Total,4218,4097,121
2011,WV1  3,WV1  3,Total,379,369,10
2011,WV1  4,WV1  4,Total,1603,1470,133
2011,WV10 0,WV10 0,Total,5180,4950,230
2011,WV10 6,WV10 6,Total,4965,4781,184
2011,WV10 7,WV10 7,Total,2651,2560,91
2011,WV10 8,WV10 8,Total,4910,4814,96
2011,WV10 9,WV10 9,Total,5576,5378,198
2011,WV11 1,WV11 1,Total,5135,4979,156
2011,WV11 2,WV11 2,Total,4764,4684,80
2011,WV11 3,WV11 3,Total,5167,5055,112
2011,WV12 4,WV12 4,Total,4492,4359,133
2011,WV12 5,WV12 5,Total,6281,6167,114
2011,WV13 1,WV13 1,Total,2378,2303,75
2011,WV13 2,WV13 2,Total,2987,2906,81
2011,WV13 3,WV13 3,Total,3246,3139,107
2011,WV14 0,WV14 0,Total,2644,2538,106
2011,WV14 6,WV14 6,Total,3588,3451,137
2011,WV14 7,WV14 7,Total,1851,1745,106
2011,WV14 8,WV14 8,Total,6186,6003,183
2011,WV14 9,WV14 9,Total,5741,5575,166
2011,WV15 5,WV15 5,Total,1639,1554,85
2011,WV15 6,WV15 6,Total,1887,1811,76
2011,WV16 4,WV16 4,Total,3524,3361,163
2011,WV16 5,WV16 5,Total,1513,1424,89
2011,WV16 6,WV16 6,Total,3046,2864,182
2011,WV2  1,WV2  1,Total,1290,1193,97
2011,WV2  2,WV2  2,Total,2318,2231,87
2011,WV2  3,WV2  3,Total,1577,1491,86
2011,WV2  4,WV2  4,Total,858,823,35
2011,WV3  0,WV3  0,Total,3278,3064,214
2011,WV3  7,WV3  7,Total,2903,2807,96
2011,WV3  8,WV3  8,Total,2819,2746,73
2011,WV3  9,WV3  9,Total,4070,3865,205
2011,WV4  4,WV4  4,Total,5658,5514,144
2011,WV4  5,WV4  5,Total,4223,4095,128
2011,WV4  6,WV4  6,Total,4433,4221,212
2011,WV5  0,WV5  0,Total,2507,2445,62
2011,WV5  7,WV5  7,Total,1174,1120,54
2011,WV5  8,WV5  8,Total,1640,1613,27
2011,WV5  9,WV5  9,Total,1524,1482,42
2011,WV6  0,WV6  0,Total,5665,5313,352
2011,WV6  7,WV6  7,Total,5659,5560,99
2011,WV6  8,WV6  8,Total,4848,4701,147
2011,WV6  9,WV6  9,Total,3164,3042,122
2011,WV7  3,WV7  3,Total,2853,2720,133
2011,WV8  1,WV8  1,Total,5002,4873,129
2011,WV8  2,WV8  2,Total,1797,1752,45
2011,WV9  5,WV9  5,Total,3245,3164,81
2011,YO1  6,YO1  6,Total,1314,1111,203
2011,YO1  7,YO1  7,Total,549,463,86
2011,YO1  9,YO1  9,Total,942,832,110
2011,YO10 3,YO10 3,Total,5164,5012,152
2011,YO10 4,YO10 4,Total,3973,3750,223
2011,YO10 5,YO10 5,Total,2074,1934,140
2011,YO11 1,YO11 1,Total,2583,2109,474
2011,YO11 2,YO11 2,Total,5068,4030,1038
2011,YO11 3,YO11 3,Total,5117,4918,199
2011,YO12 4,YO12 4,Total,3961,3761,200
2011,YO12 5,YO12 5,Total,4739,4529,210
2011,YO12 6,YO12 6,Total,4854,4591,263
2011,YO12 7,YO12 7,Total,5477,4869,608
2011,YO13 0,YO13 0,Total,2557,2336,221
2011,YO13 9,YO13 9,Total,2328,2176,152
2011,YO14 0,YO14 0,Total,2862,2604,258
2011,YO14 9,YO14 9,Total,3555,2777,778
2011,YO15 1,YO15 1,Total,1935,1625,310
2011,YO15 2,YO15 2,Total,2735,2246,489
2011,YO15 3,YO15 3,Total,2765,2404,361
2011,YO16 4,YO16 4,Total,4558,4172,386
2011,YO16 6,YO16 6,Total,3861,3590,271
2011,YO16 7,YO16 7,Total,4206,3970,236
2011,YO17 6,YO17 6,Total,1249,1156,93
2011,YO17 7,YO17 7,Total,2377,2243,134
2011,YO17 8,YO17 8,Total,2625,2436,189
2011,YO17 9,YO17 9,Total,3464,3323,141
2011,YO18 7,YO18 7,Total,2875,2536,339
2011,YO18 8,YO18 8,Total,2634,2338,296
2011,YO19 4,YO19 4,Total,607,586,21
2011,YO19 5,YO19 5,Total,1915,1853,62
2011,YO19 6,YO19 6,Total,2808,2698,110
2011,YO21 1,YO21 1,Total,3100,2706,394
2011,YO21 2,YO21 2,Total,1439,1253,186
2011,YO21 3,YO21 3,Total,3326,2432,894
2011,YO22 4,YO22 4,Total,3410,2580,830
2011,YO22 5,YO22 5,Total,1586,1329,257
2011,YO23 1,YO23 1,Total,4223,3988,235
2011,YO23 2,YO23 2,Total,1789,1736,53
2011,YO23 3,YO23 3,Total,2437,2383,54
2011,YO23 7,YO23 7,Total,449,421,28
2011,YO24 1,YO24 1,Total,2442,2318,124
2011,YO24 2,YO24 2,Total,3407,3334,73
2011,YO24 3,YO24 3,Total,3835,3763,72
2011,YO24 4,YO24 4,Total,3836,3728,108
2011,YO25 3,YO25 3,Total,1128,1035,93
2011,YO25 4,YO25 4,Total,2151,2044,107
2011,YO25 5,YO25 5,Total,3016,2962,54
2011,YO25 6,YO25 6,Total,2941,2797,144
2011,YO25 8,YO25 8,Total,2732,2584,148
2011,YO25 9,YO25 9,Total,3152,3043,109
2011,YO26 4,YO26 4,Total,3106,2962,144
2011,YO26 5,YO26 5,Total,4940,4848,92
2011,YO26 6,YO26 6,Total,2293,2244,49
2011,YO26 7,YO26 7,Total,866,848,18
2011,YO26 8,YO26 8,Total,1210,1158,52
2011,YO26 9,YO26 9,Total,565,536,29
2011,YO30 1,YO30 1,Total,1020,985,35
2011,YO30 2,YO30 2,Total,654,623,31
2011,YO30 4,YO30 4,Total,1162,1150,12
2011,YO30 5,YO30 5,Total,3275,3199,76
2011,YO30 6,YO30 6,Total,4227,4080,147
2011,YO30 7,YO30 7,Total,1261,1129,132
2011,YO31 0,YO31 0,Total,2687,2616,71
2011,YO31 1,YO31 1,Total,2147,2093,54
2011,YO31 7,YO31 7,Total,2755,2544,211
2011,YO31 8,YO31 8,Total,2996,2910,86
2011,YO31 9,YO31 9,Total,2916,2833,83
2011,YO32 2,YO32 2,Total,2354,2293,61
2011,YO32 3,YO32 3,Total,3034,2977,57
2011,YO32 4,YO32 4,Total,1284,1274,10
2011,YO32 5,YO32 5,Total,2395,2336,59
2011,YO32 9,YO32 9,Total,3318,3257,61
2011,YO41 1,YO41 1,Total,2294,2238,56
2011,YO41 4,YO41 4,Total,864,832,32
2011,YO41 5,YO41 5,Total,1134,1110,24
2011,YO42 1,YO42 1,Total,891,842,49
2011,YO42 2,YO42 2,Total,3733,3623,110
2011,YO42 4,YO42 4,Total,1774,1694,80
2011,YO43 3,YO43 3,Total,3313,3163,150
2011,YO43 4,YO43 4,Total,2155,2062,93
2011,YO51 9,YO51 9,Total,2474,2359,115
2011,YO60 6,YO60 6,Total,798,733,65
2011,YO60 7,YO60 7,Total,1461,1371,90
2011,YO61 1,YO61 1,Total,2143,2070,73
2011,YO61 2,YO61 2,Total,525,497,28
2011,YO61 3,YO61 3,Total,2575,2476,99
2011,YO61 4,YO61 4,Total,1017,936,81
2011,YO62 4,YO62 4,Total,1124,1017,107
2011,YO62 5,YO62 5,Total,1516,1310,206
2011,YO62 6,YO62 6,Total,2330,2044,286
2011,YO62 7,YO62 7,Total,918,776,142
2011,YO7  1,YO7  1,Total,4367,4157,210
2011,YO7  2,YO7  2,Total,1267,1135,132
2011,YO7  3,YO7  3,Total,1666,1577,89
2011,YO7  4,YO7  4,Total,1504,1456,48
2011,YO8  3,YO8  3,Total,2082,1940,142
2011,YO8  4,YO8  4,Total,3239,3044,195
2011,YO8  5,YO8  5,Total,2784,2688,96
2011,YO8  6,YO8  6,Total,2130,2031,99
2011,YO8  8,YO8  8,Total,3615,3400,215
2011,YO8  9,YO8  9,Total,5325,5123,202
2011,CF10 1,CF10 1,Total,669,505,164
2011,CF10 2,CF10 2,Total,1154,1003,151
2011,CF10 3,CF10 3,Total,410,385,25
2011,CF10 4,CF10 4,Total,2555,2357,198
2011,CF10 5,CF10 5,Total,3487,3011,476
2011,CF11 0,CF11 0,Total,1511,1396,115
2011,CF11 6,CF11 6,Total,5041,4742,299
2011,CF11 7,CF11 7,Total,4374,4137,237
2011,CF11 8,CF11 8,Total,1642,1614,28
2011,CF11 9,CF11 9,Total,4037,3740,297
2011,CF14 0,CF14 0,Total,2183,2128,55
2011,CF14 1,CF14 1,Total,4553,4405,148
2011,CF14 2,CF14 2,Total,4735,4593,142
2011,CF14 3,CF14 3,Total,3739,3560,179
2011,CF14 4,CF14 4,Total,3751,3651,100
2011,CF14 5,CF14 5,Total,4234,4097,137
2011,CF14 6,CF14 6,Total,4213,4084,129
2011,CF14 7,CF14 7,Total,2119,2058,61
2011,CF14 9,CF14 9,Total,3044,2990,54
2011,CF15 7,CF15 7,Total,2448,2394,54
2011,CF15 8,CF15 8,Total,2636,2552,84
2011,CF15 9,CF15 9,Total,2426,2379,47
2011,CF23 5,CF23 5,Total,3987,3812,175
2011,CF23 6,CF23 6,Total,4269,4128,141
2011,CF23 7,CF23 7,Total,3245,3184,61
2011,CF23 8,CF23 8,Total,2929,2870,59
2011,CF23 9,CF23 9,Total,4650,4535,115
2011,CF24 0,CF24 0,Total,1956,1840,116
2011,CF24 1,CF24 1,Total,2672,2496,176
2011,CF24 2,CF24 2,Total,5921,5745,176
2011,CF24 3,CF24 3,Total,5467,5160,307
2011,CF24 4,CF24 4,Total,6390,6057,333
2011,CF24 5,CF24 5,Total,121,118,3
2011,CF3  0,CF3  0,Total,5079,4967,112
2011,CF3  1,CF3  1,Total,2011,1953,58
2011,CF3  2,CF3  2,Total,1248,1220,28
2011,CF3  3,CF3  3,Total,2856,2758,98
2011,CF3  4,CF3  4,Total,2660,2569,91
2011,CF3  5,CF3  5,Total,3394,3285,109
2011,CF3  6,CF3  6,Total,569,539,30
2011,CF31 1,CF31 1,Total,4327,4140,187
2011,CF31 2,CF31 2,Total,4922,4801,121
2011,CF31 3,CF31 3,Total,1931,1823,108
2011,CF31 4,CF31 4,Total,5883,5695,188
2011,CF31 5,CF31 5,Total,2299,2263,36
2011,CF32 0,CF32 0,Total,2266,2128,138
2011,CF32 7,CF32 7,Total,2973,2735,238
2011,CF32 8,CF32 8,Total,3439,3230,209
2011,CF32 9,CF32 9,Total,4856,4693,163
2011,CF33 4,CF33 4,Total,3127,3023,104
2011,CF33 6,CF33 6,Total,3248,3145,103
2011,CF34 0,CF34 0,Total,4984,4695,289
2011,CF34 9,CF34 9,Total,4298,4079,219
2011,CF35 5,CF35 5,Total,2461,2389,72
2011,CF35 6,CF35 6,Total,3835,3725,110
2011,CF36 3,CF36 3,Total,4594,4073,521
2011,CF36 5,CF36 5,Total,3326,3079,247
2011,CF37 1,CF37 1,Total,4131,3860,271
2011,CF37 2,CF37 2,Total,2545,2403,142
2011,CF37 3,CF37 3,Total,3319,3183,136
2011,CF37 4,CF37 4,Total,3171,3013,158
2011,CF37 5,CF37 5,Total,3718,3564,154
2011,CF38 1,CF38 1,Total,4099,4024,75
2011,CF38 2,CF38 2,Total,5516,5422,94
2011,CF39 0,CF39 0,Total,2538,2379,159
2011,CF39 8,CF39 8,Total,6405,6219,186
2011,CF39 9,CF39 9,Total,3786,3612,174
2011,CF40 1,CF40 1,Total,4266,4034,232
2011,CF40 2,CF40 2,Total,5091,4735,356
2011,CF41 7,CF41 7,Total,5054,4696,358
2011,CF42 5,CF42 5,Total,2979,2704,275
2011,CF42 6,CF42 6,Total,3476,3231,245
2011,CF43 3,CF43 3,Total,2300,2037,263
2011,CF43 4,CF43 4,Total,3551,3260,291
2011,CF44 0,CF44 0,Total,3598,3407,191
2011,CF44 6,CF44 6,Total,4649,4329,320
2011,CF44 7,CF44 7,Total,1910,1691,219
2011,CF44 8,CF44 8,Total,4060,3827,233
2011,CF44 9,CF44 9,Total,3932,3694,238
2011,CF45 3,CF45 3,Total,4729,4397,332
2011,CF45 4,CF45 4,Total,4223,4006,217
2011,CF46 5,CF46 5,Total,2794,2548,246
2011,CF46 6,CF46 6,Total,3581,3365,216
2011,CF47 0,CF47 0,Total,3420,3161,259
2011,CF47 8,CF47 8,Total,1661,1513,148
2011,CF47 9,CF47 9,Total,4624,4346,278
2011,CF48 1,CF48 1,Total,3853,3648,205
2011,CF48 2,CF48 2,Total,2772,2600,172
2011,CF48 3,CF48 3,Total,2020,1810,210
2011,CF48 4,CF48 4,Total,3586,3251,335
2011,CF5  1,CF5  1,Total,5221,5044,177
2011,CF5  2,CF5  2,Total,4394,4216,178
2011,CF5  3,CF5  3,Total,5643,5526,117
2011,CF5  4,CF5  4,Total,6862,6710,152
2011,CF5  5,CF5  5,Total,4846,4735,111
2011,CF5  6,CF5  6,Total,2019,1951,68
2011,CF61 1,CF61 1,Total,2018,1938,80
2011,CF61 2,CF61 2,Total,2227,2161,66
2011,CF62 3,CF62 3,Total,2898,2811,87
2011,CF62 4,CF62 4,Total,1856,1712,144
2011,CF62 5,CF62 5,Total,1188,1156,32
2011,CF62 6,CF62 6,Total,2672,2562,110
2011,CF62 7,CF62 7,Total,3287,3140,147
2011,CF62 8,CF62 8,Total,3197,3134,63
2011,CF62 9,CF62 9,Total,2644,2607,37
2011,CF63 1,CF63 1,Total,3903,3803,100
2011,CF63 2,CF63 2,Total,2534,2455,79
2011,CF63 3,CF63 3,Total,654,631,23
2011,CF63 4,CF63 4,Total,2728,2606,122
2011,CF64 1,CF64 1,Total,2812,2639,173
2011,CF64 2,CF64 2,Total,3587,3485,102
2011,CF64 3,CF64 3,Total,3695,3543,152
2011,CF64 4,CF64 4,Total,3415,3333,82
2011,CF64 5,CF64 5,Total,3108,2906,202
2011,CF71 7,CF71 7,Total,4055,3836,219
2011,CF72 8,CF72 8,Total,4669,4564,105
2011,CF72 9,CF72 9,Total,6288,6072,216
2011,CF81 8,CF81 8,Total,3746,3566,180
2011,CF81 9,CF81 9,Total,3521,3393,128
2011,CF82 6,CF82 6,Total,390,331,59
2011,CF82 7,CF82 7,Total,5540,5361,179
2011,CF82 8,CF82 8,Total,2609,2527,82
2011,CF83 1,CF83 1,Total,5440,5286,154
2011,CF83 2,CF83 2,Total,5206,5079,127
2011,CF83 3,CF83 3,Total,5376,5217,159
2011,CF83 4,CF83 4,Total,2906,2778,128
2011,CF83 8,CF83 8,Total,4532,4420,112
2011,LD1  5,LD1  5,Total,2855,2578,277
2011,LD1  6,LD1  6,Total,2892,2624,268
2011,LD2  3,LD2  3,Total,2762,2502,260
2011,LD3  0,LD3  0,Total,1962,1790,172
2011,LD3  7,LD3  7,Total,2546,2290,256
2011,LD3  8,LD3  8,Total,2122,1895,227
2011,LD3  9,LD3  9,Total,2452,2314,138
2011,LD4  4,LD4  4,Total,391,355,36
2011,LD5  4,LD5  4,Total,547,483,64
2011,LD6  5,LD6  5,Total,1392,1233,159
2011,LD7  1,LD7  1,Total,2367,2172,195
2011,LD8  2,LD8  2,Total,2065,1876,189
2011,LL11 1,LL11 1,Total,366,336,30
2011,LL11 2,LL11 2,Total,3375,3252,123
2011,LL11 3,LL11 3,Total,3116,3014,102
2011,LL11 4,LL11 4,Total,3883,3789,94
2011,LL11 5,LL11 5,Total,2940,2860,80
2011,LL11 6,LL11 6,Total,2980,2897,83
2011,LL12 0,LL12 0,Total,3482,3340,142
2011,LL12 7,LL12 7,Total,3394,3294,100
2011,LL12 8,LL12 8,Total,3338,3248,90
2011,LL12 9,LL12 9,Total,2216,2141,75
2011,LL13 0,LL13 0,Total,3430,3288,142
2011,LL13 7,LL13 7,Total,3535,3388,147
2011,LL13 8,LL13 8,Total,3655,3550,105
2011,LL13 9,LL13 9,Total,4542,4420,122
2011,LL14 1,LL14 1,Total,2279,2186,93
2011,LL14 2,LL14 2,Total,3562,3457,105
2011,LL14 3,LL14 3,Total,3040,2949,91
2011,LL14 4,LL14 4,Total,1775,1726,49
2011,LL14 5,LL14 5,Total,2257,2183,74
2011,LL14 6,LL14 6,Total,1861,1784,77
2011,LL15 1,LL15 1,Total,3416,3182,234
2011,LL15 2,LL15 2,Total,1541,1431,110
2011,LL16 3,LL16 3,Total,2971,2844,127
2011,LL16 4,LL16 4,Total,2133,2033,100
2011,LL16 5,LL16 5,Total,1821,1738,83
2011,LL17 0,LL17 0,Total,2336,2233,103
2011,LL18 1,LL18 1,Total,2049,1865,184
2011,LL18 2,LL18 2,Total,3775,3654,121
2011,LL18 3,LL18 3,Total,2365,2219,146
2011,LL18 4,LL18 4,Total,4604,4473,131
2011,LL18 5,LL18 5,Total,4220,4060,160
2011,LL18 6,LL18 6,Total,1433,1360,73
2011,LL19 7,LL19 7,Total,3362,3204,158
2011,LL19 8,LL19 8,Total,3551,3433,118
2011,LL19 9,LL19 9,Total,2207,2135,72
2011,LL20 7,LL20 7,Total,2194,2002,192
2011,LL20 8,LL20 8,Total,1777,1620,157
2011,LL21 0,LL21 0,Total,1135,1006,129
2011,LL21 9,LL21 9,Total,1754,1605,149
2011,LL22 7,LL22 7,Total,4238,3954,284
2011,LL22 8,LL22 8,Total,2567,2313,254
2011,LL22 9,LL22 9,Total,1934,1803,131
2011,LL23 7,LL23 7,Total,2186,1932,254
2011,LL24 0,LL24 0,Total,1119,832,287
2011,LL25 0,LL25 0,Total,295,218,77
2011,LL26 0,LL26 0,Total,2230,1988,242
2011,LL27 0,LL27 0,Total,429,368,61
2011,LL28 4,LL28 4,Total,4172,3843,329
2011,LL28 5,LL28 5,Total,2728,2556,172
2011,LL29 6,LL29 6,Total,750,740,10
2011,LL29 7,LL29 7,Total,2060,1895,165
2011,LL29 8,LL29 8,Total,3078,2810,268
2011,LL29 9,LL29 9,Total,3409,3287,122
2011,LL30 1,LL30 1,Total,4775,4382,393
2011,LL30 2,LL30 2,Total,3964,3449,515
2011,LL30 3,LL30 3,Total,2422,2270,152
2011,LL31 9,LL31 9,Total,4529,4112,417
2011,LL32 8,LL32 8,Total,3405,2950,455
2011,LL33 0,LL33 0,Total,1805,1636,169
2011,LL34 6,LL34 6,Total,2269,1975,294
2011,LL35 0,LL35 0,Total,898,492,406
2011,LL36 0,LL36 0,Total,964,796,168
2011,LL36 9,LL36 9,Total,1757,1477,280
2011,LL37 2,LL37 2,Total,316,236,80
2011,LL38 2,LL38 2,Total,506,383,123
2011,LL39 1,LL39 1,Total,213,150,63
2011,LL40 1,LL40 1,Total,1203,1026,177
2011,LL40 2,LL40 2,Total,1059,889,170
2011,LL41 3,LL41 3,Total,1655,1453,202
2011,LL41 4,LL41 4,Total,1845,1544,301
2011,LL42 1,LL42 1,Total,1492,1245,247
2011,LL43 2,LL43 2,Total,274,240,34
2011,LL44 2,LL44 2,Total,604,511,93
2011,LL45 2,LL45 2,Total,362,293,69
2011,LL46 2,LL46 2,Total,1207,911,296
2011,LL47 6,LL47 6,Total,356,270,86
2011,LL48 6,LL48 6,Total,1248,1122,126
2011,LL49 9,LL49 9,Total,2724,2159,565
2011,LL51 9,LL51 9,Total,314,259,55
2011,LL52 0,LL52 0,Total,1461,1196,265
2011,LL53 5,LL53 5,Total,2388,2150,238
2011,LL53 6,LL53 6,Total,2924,2414,510
2011,LL53 7,LL53 7,Total,2675,1666,1009
2011,LL53 8,LL53 8,Total,1943,1519,424
2011,LL54 5,LL54 5,Total,1668,1379,289
2011,LL54 6,LL54 6,Total,2034,1816,218
2011,LL54 7,LL54 7,Total,1809,1628,181
2011,LL55 1,LL55 1,Total,2461,2339,122
2011,LL55 2,LL55 2,Total,3045,2898,147
2011,LL55 3,LL55 3,Total,1415,1308,107
2011,LL55 4,LL55 4,Total,3113,2769,344
2011,LL56 4,LL56 4,Total,1177,1006,171
2011,LL57 1,LL57 1,Total,2415,2295,120
2011,LL57 2,LL57 2,Total,2970,2863,107
2011,LL57 3,LL57 3,Total,2550,2401,149
2011,LL57 4,LL57 4,Total,2672,2509,163
2011,LL58 8,LL58 8,Total,2181,1858,323
2011,LL59 5,LL59 5,Total,2649,2461,188
2011,LL60 6,LL60 6,Total,1451,1343,108
2011,LL61 5,LL61 5,Total,1328,1270,58
2011,LL61 6,LL61 6,Total,1439,1275,164
2011,LL62 5,LL62 5,Total,807,717,90
2011,LL63 5,LL63 5,Total,718,629,89
2011,LL64 5,LL64 5,Total,853,489,364
2011,LL65 1,LL65 1,Total,2599,2448,151
2011,LL65 2,LL65 2,Total,4316,3754,562
2011,LL65 3,LL65 3,Total,2809,2653,156
2011,LL65 4,LL65 4,Total,1615,1437,178
2011,LL67 0,LL67 0,Total,752,646,106
2011,LL68 0,LL68 0,Total,604,551,53
2011,LL68 9,LL68 9,Total,2454,2243,211
2011,LL69 9,LL69 9,Total,290,261,29
2011,LL70 9,LL70 9,Total,199,145,54
2011,LL71 7,LL71 7,Total,93,83,10
2011,LL71 8,LL71 8,Total,690,634,56
2011,LL72 8,LL72 8,Total,463,346,117
2011,LL73 8,LL73 8,Total,164,127,37
2011,LL74 8,LL74 8,Total,1281,1117,164
2011,LL75 8,LL75 8,Total,716,626,90
2011,LL76 8,LL76 8,Total,151,134,17
2011,LL77 7,LL77 7,Total,3300,3128,172
2011,LL78 8,LL78 8,Total,261,219,42
2011,NP10 0,NP10 0,Total,668,654,14
2011,NP10 8,NP10 8,Total,5233,5077,156
2011,NP10 9,NP10 9,Total,3937,3852,85
2011,NP11 3,NP11 3,Total,2052,1998,54
2011,NP11 4,NP11 4,Total,2626,2495,131
2011,NP11 5,NP11 5,Total,2915,2774,141
2011,NP11 6,NP11 6,Total,5139,4973,166
2011,NP11 7,NP11 7,Total,4151,3950,201
2011,NP12 0,NP12 0,Total,3325,3208,117
2011,NP12 1,NP12 1,Total,3535,3439,96
2011,NP12 2,NP12 2,Total,3739,3641,98
2011,NP12 3,NP12 3,Total,3487,3384,103
2011,NP13 1,NP13 1,Total,4076,3829,247
2011,NP13 2,NP13 2,Total,3045,2834,211
2011,NP13 3,NP13 3,Total,2162,2075,87
2011,NP15 1,NP15 1,Total,2323,2183,140
2011,NP15 2,NP15 2,Total,1081,1035,46
2011,NP16 5,NP16 5,Total,4997,4830,167
2011,NP16 6,NP16 6,Total,2869,2719,150
2011,NP16 7,NP16 7,Total,2435,2269,166
2011,NP18 1,NP18 1,Total,2145,2059,86
2011,NP18 2,NP18 2,Total,2594,2511,83
2011,NP18 3,NP18 3,Total,2395,2305,90
2011,NP19 0,NP19 0,Total,4700,4466,234
2011,NP19 4,NP19 4,Total,2038,1984,54
2011,NP19 7,NP19 7,Total,5798,5547,251
2011,NP19 8,NP19 8,Total,4187,3898,289
2011,NP19 9,NP19 9,Total,5844,5665,179
2011,NP20 1,NP20 1,Total,348,310,38
2011,NP20 2,NP20 2,Total,3340,3093,247
2011,NP20 3,NP20 3,Total,4940,4797,143
2011,NP20 4,NP20 4,Total,3154,2939,215
2011,NP20 5,NP20 5,Total,4401,4260,141
2011,NP20 6,NP20 6,Total,3415,3363,52
2011,NP20 7,NP20 7,Total,3357,3306,51
2011,NP22 3,NP22 3,Total,3656,3475,181
2011,NP22 4,NP22 4,Total,3346,3256,90
2011,NP22 5,NP22 5,Total,3153,3016,137
2011,NP23 4,NP23 4,Total,4524,4341,183
2011,NP23 5,NP23 5,Total,4724,4548,176
2011,NP23 6,NP23 6,Total,3872,3668,204
2011,NP23 7,NP23 7,Total,1333,1226,107
2011,NP23 8,NP23 8,Total,565,548,17
2011,NP24 6,NP24 6,Total,2268,2110,158
2011,NP25 3,NP25 3,Total,2425,2289,136
2011,NP25 4,NP25 4,Total,1460,1377,83
2011,NP25 5,NP25 5,Total,2862,2704,158
2011,NP26 3,NP26 3,Total,3718,3651,67
2011,NP26 4,NP26 4,Total,3257,3158,99
2011,NP26 5,NP26 5,Total,2424,2339,85
2011,NP4  0,NP4  0,Total,3509,3384,125
2011,NP4  5,NP4  5,Total,4095,3904,191
2011,NP4  6,NP4  6,Total,3383,3105,278
2011,NP4  7,NP4  7,Total,2945,2850,95
2011,NP4  8,NP4  8,Total,3549,3370,179
2011,NP4  9,NP4  9,Total,2817,2645,172
2011,NP44 1,NP44 1,Total,3755,3609,146
2011,NP44 2,NP44 2,Total,2581,2486,95
2011,NP44 3,NP44 3,Total,3220,3128,92
2011,NP44 4,NP44 4,Total,2795,2684,111
2011,NP44 5,NP44 5,Total,2424,2298,126
2011,NP44 6,NP44 6,Total,2026,1995,31
2011,NP44 7,NP44 7,Total,2328,2248,80
2011,NP44 8,NP44 8,Total,1516,1483,33
2011,NP7  0,NP7  0,Total,1803,1716,87
2011,NP7  5,NP7  5,Total,2420,2256,164
2011,NP7  6,NP7  6,Total,2589,2526,63
2011,NP7  7,NP7  7,Total,1501,1337,164
2011,NP7  8,NP7  8,Total,1348,1252,96
2011,NP7  9,NP7  9,Total,2464,2348,116
2011,NP8  1,NP8  1,Total,2695,2396,299
2011,SA1  1,SA1  1,Total,2546,2235,311
2011,SA1  2,SA1  2,Total,2625,2565,60
2011,SA1  3,SA1  3,Total,1878,1760,118
2011,SA1  4,SA1  4,Total,1964,1804,160
2011,SA1  5,SA1  5,Total,395,348,47
2011,SA1  6,SA1  6,Total,7362,7036,326
2011,SA1  7,SA1  7,Total,2958,2844,114
2011,SA1  8,SA1  8,Total,3649,3456,193
2011,SA10 6,SA10 6,Total,4134,3868,266
2011,SA10 7,SA10 7,Total,4490,4305,185
2011,SA10 8,SA10 8,Total,2897,2795,102
2011,SA10 9,SA10 9,Total,1734,1629,105
2011,SA11 1,SA11 1,Total,3188,2945,243
2011,SA11 2,SA11 2,Total,4775,4461,314
2011,SA11 3,SA11 3,Total,5062,4851,211
2011,SA11 4,SA11 4,Total,1451,1360,91
2011,SA11 5,SA11 5,Total,2650,2505,145
2011,SA12 6,SA12 6,Total,5096,4752,344
2011,SA12 7,SA12 7,Total,3723,3633,90
2011,SA12 8,SA12 8,Total,3115,2924,191
2011,SA12 9,SA12 9,Total,3128,2947,181
2011,SA13 1,SA13 1,Total,2835,2555,280
2011,SA13 2,SA13 2,Total,3748,3575,173
2011,SA13 3,SA13 3,Total,2431,2264,167
2011,SA14 6,SA14 6,Total,2938,2779,159
2011,SA14 7,SA14 7,Total,2891,2682,209
2011,SA14 8,SA14 8,Total,5555,5385,170
2011,SA14 9,SA14 9,Total,3485,3340,145
2011,SA15 1,SA15 1,Total,4396,4148,248
2011,SA15 2,SA15 2,Total,4237,3919,318
2011,SA15 3,SA15 3,Total,3237,3061,176
2011,SA15 4,SA15 4,Total,2380,2257,123
2011,SA15 5,SA15 5,Total,2955,2760,195
2011,SA16 0,SA16 0,Total,4096,3781,315
2011,SA17 4,SA17 4,Total,2801,2625,176
2011,SA17 5,SA17 5,Total,1560,1387,173
2011,SA18 1,SA18 1,Total,4416,4149,267
2011,SA18 2,SA18 2,Total,4097,3916,181
2011,SA18 3,SA18 3,Total,4908,4704,204
2011,SA19 6,SA19 6,Total,1490,1386,104
2011,SA19 7,SA19 7,Total,1208,1122,86
2011,SA19 8,SA19 8,Total,1041,935,106
2011,SA19 9,SA19 9,Total,726,652,74
2011,SA2  0,SA2  0,Total,5377,5124,253
2011,SA2  7,SA2  7,Total,4710,4533,177
2011,SA2  8,SA2  8,Total,2775,2693,82
2011,SA2  9,SA2  9,Total,3014,2909,105
2011,SA20 0,SA20 0,Total,1720,1545,175
2011,SA3  1,SA3  1,Total,1722,1279,443
2011,SA3  2,SA3  2,Total,1315,1164,151
2011,SA3  3,SA3  3,Total,1837,1657,180
2011,SA3  4,SA3  4,Total,4031,3476,555
2011,SA3  5,SA3  5,Total,4523,4273,250
2011,SA31 1,SA31 1,Total,2961,2754,207
2011,SA31 2,SA31 2,Total,1813,1732,81
2011,SA31 3,SA31 3,Total,3078,2900,178
2011,SA32 7,SA32 7,Total,1802,1667,135
2011,SA32 8,SA32 8,Total,1653,1571,82
2011,SA33 4,SA33 4,Total,2468,2262,206
2011,SA33 5,SA33 5,Total,1395,1255,140
2011,SA33 6,SA33 6,Total,1757,1632,125
2011,SA34 0,SA34 0,Total,2422,2215,207
2011,SA35 0,SA35 0,Total,324,294,30
2011,SA36 0,SA36 0,Total,178,160,18
2011,SA37 0,SA37 0,Total,613,551,62
2011,SA38 9,SA38 9,Total,2284,2101,183
2011,SA39 9,SA39 9,Total,1044,974,70
2011,SA4  0,SA4  0,Total,1362,1312,50
2011,SA4  3,SA4  3,Total,4522,4327,195
2011,SA4  4,SA4  4,Total,4976,4789,187
2011,SA4  6,SA4  6,Total,3164,3077,87
2011,SA4  8,SA4  8,Total,2960,2822,138
2011,SA4  9,SA4  9,Total,2424,2360,64
2011,SA40 9,SA40 9,Total,1623,1510,113
2011,SA41 3,SA41 3,Total,907,793,114
2011,SA42 0,SA42 0,Total,1651,1104,547
2011,SA43 1,SA43 1,Total,2457,2251,206
2011,SA43 2,SA43 2,Total,2690,2393,297
2011,SA43 3,SA43 3,Total,1435,1198,237
2011,SA44 4,SA44 4,Total,1831,1683,148
2011,SA44 5,SA44 5,Total,2285,2133,152
2011,SA44 6,SA44 6,Total,1408,1157,251
2011,SA45 9,SA45 9,Total,1137,809,328
2011,SA46 0,SA46 0,Total,1475,1310,165
2011,SA47 0,SA47 0,Total,571,518,53
2011,SA48 7,SA48 7,Total,1926,1778,148
2011,SA48 8,SA48 8,Total,2075,1897,178
2011,SA5  4,SA5  4,Total,2531,2415,116
2011,SA5  5,SA5  5,Total,3510,3446,64
2011,SA5  7,SA5  7,Total,2738,2690,48
2011,SA5  8,SA5  8,Total,3712,3636,76
2011,SA5  9,SA5  9,Total,3621,3524,97
2011,SA6  5,SA6  5,Total,4138,3844,294
2011,SA6  6,SA6  6,Total,5904,5757,147
2011,SA6  7,SA6  7,Total,3349,3250,99
2011,SA6  8,SA6  8,Total,2217,2066,151
2011,SA61 1,SA61 1,Total,3849,3636,213
2011,SA61 2,SA61 2,Total,2887,2666,221
2011,SA62 3,SA62 3,Total,2639,2119,520
2011,SA62 4,SA62 4,Total,1957,1862,95
2011,SA62 5,SA62 5,Total,2697,2334,363
2011,SA62 6,SA62 6,Total,3194,2489,705
2011,SA63 4,SA63 4,Total,471,450,21
2011,SA64 0,SA64 0,Total,1275,1105,170
2011,SA65 9,SA65 9,Total,2269,2021,248
2011,SA66 7,SA66 7,Total,1385,1283,102
2011,SA67 7,SA67 7,Total,1136,1069,67
2011,SA67 8,SA67 8,Total,2187,1867,320
2011,SA68 0,SA68 0,Total,2008,1831,177
2011,SA69 9,SA69 9,Total,2112,1585,527
2011,SA7  0,SA7  0,Total,816,788,28
2011,SA7  9,SA7  9,Total,5585,5428,157
2011,SA70 7,SA70 7,Total,2195,1592,603
2011,SA70 8,SA70 8,Total,3303,2755,548
2011,SA71 4,SA71 4,Total,2725,2501,224
2011,SA71 5,SA71 5,Total,2584,2039,545
2011,SA72 4,SA72 4,Total,376,336,40
2011,SA72 6,SA72 6,Total,4503,4171,332
2011,SA73 1,SA73 1,Total,3799,3603,196
2011,SA73 2,SA73 2,Total,3224,3041,183
2011,SA73 3,SA73 3,Total,2376,2269,107
2011,SA8  3,SA8  3,Total,2064,1981,83
2011,SA8  4,SA8  4,Total,3542,3327,215
2011,SA9  1,SA9  1,Total,3749,3493,256
2011,SA9  2,SA9  2,Total,3478,3232,246
